n	ṅ
sangāhabalaṃ	saṅgāhabalaṃ
tenupankamissāmāti	tenupaṅkamissāmāti
nangulīhi	naṅgulīhi
navahangehi	navahaṅgehi
pāṭikankhanti	pāṭikaṅkhanti
angantveva	aṅgantveva
imināpangena	imināpaṅgena
sankhārātissa	saṅkhārātissa
bojjhangātissa	bojjhaṅgātissa
sankhasaddotveva	saṅkhasaddotveva
sangharakkhitosīti	saṅgharakkhitosīti
aṭṭhangikamāhuposathaṃ	aṭṭhaṅgikamāhuposathaṃ
cankīpi	caṅkīpi
sangāti	saṅgāti
langīti	laṅgīti
anganti	aṅganti
pankoti	paṅkoti
kankāpi	kaṅkāpi
sangoti	saṅgoti
tadingha	tadiṅgha
angavāto	aṅgavāto
pāmango	pāmaṅgo
dūtangā	dūtaṅgā
angahīno	aṅgahīno
sankhāpi	saṅkhāpi
kankhāhu	kaṅkhāhu
sanghoti	saṅghoti
inghayyā	iṅghayyā
sanghepi	saṅghepi
inghāyyā	iṅghāyyā
inghāyya	iṅghāyya
sanghañhi	saṅghañhi
sanghopi	saṅghopi
ekangampi	ekaṅgampi
sanghova	saṅghova
sanghañca	saṅghañca
sankhampi	saṅkhampi
ankeneva	aṅkeneva
sankhāti	saṅkhāti
susangītā	susaṅgītā
angānipi	aṅgānipi
kinkāraṇā	kiṅkāraṇā
sangamimaṃ	saṅgamimaṃ
bhinkova	bhiṅkova
sangahoti	saṅgahoti
tankāraṇā	taṅkāraṇā
sanghādi	saṅghādi
kāmapanko	kāmapaṅko
sattango	sattaṅgo
singālopi	siṅgālopi
lingatopi	liṅgatopi
vangīsāti	vaṅgīsāti
sāngaṇova	sāṅgaṇova
sankhāyekaṃ	saṅkhāyekaṃ
tīṇangāni	tīṇaṅgāni
tīhangehi	tīhaṅgehi
inghāvuso	iṅghāvuso
singāloti	siṅgāloti
sankārampi	saṅkārampi
angaṇanti	aṅgaṇanti
vangisoti	vaṅgisoti
sankārañca	saṅkārañca
sanketampi	saṅketampi
dasangena	dasaṅgena
lingenapi	liṅgenapi
bhanganti	bhaṅganti
katangiko	kataṅgiko
pingiyāti	piṅgiyāti
ekacankame	ekacaṅkame
sanghagaru	saṅghagaru
hingujatuṃ	hiṅgujatuṃ
dussangahā	dussaṅgahā
pankadharī	paṅkadharī
pankadanto	paṅkadanto
sangātīto	saṅgātīto
sanketañca	saṅketañca
bhedāsankī	bhedāsaṅkī
nāngulīhi	nāṅgulīhi
cankamañca	caṅkamañca
devasangho	devasaṅgho
sankhyampi	saṅkhyampi
ucchangañca	ucchaṅgañca
sankhāreyeva	saṅkhāreyeva
pabhangūti	pabhaṅgūti
kankhāmīti	kaṅkhāmīti
pallankampi	pallaṅkampi
sāsankanti	sāsaṅkanti
anangaṇova	anaṅgaṇova
nelanganti	nelaṅganti
vibhangañca	vibhaṅgañca
kankhasīti	kaṅkhasīti
langhakāpi	laṅghakāpi
sankhatoti	saṅkhatoti
alankarāti	alaṅkarāti
sanghāṭipi	saṅghāṭipi
alankāroti	alaṅkāroti
sankhārāpi	saṅkhārāpi
pabhanguñca	pabhaṅguñca
dvīhangehi	dvīhaṅgehi
ekangametaṃ	ekaṅgametaṃ
sankhakulaṃ	saṅkhakulaṃ
sankhārāti	saṅkhārāti
inghāyasmā	iṅghāyasmā
sanghāṭīti	saṅghāṭīti
cūḷasangāma	cūḷasaṅgāma
sangītinti	saṅgītinti
sanghenāti	saṅghenāti
sanghappatto	saṅghappatto
sangāyantehi	saṅgāyantehi
navasangahā	navasaṅgahā
sanghikañca	saṅghikañca
mahāsangāma	mahāsaṅgāma
bhangodakaṃ	bhaṅgodakaṃ
pankapalipā	paṅkapalipā
sanghaphāsu	saṅghaphāsu
sakesangesu	sakesaṅgesu
kankaṇaṃva	kaṅkaṇaṃva
kāmapankena	kāmapaṅkena
pankamhiva	paṅkamhiva
ucchangepi	ucchaṅgepi
sangahavāra	saṅgahavāra
angajātañca	aṅgajātañca
pāṭankinti	pāṭaṅkinti
cūḷasangāme	cūḷasaṅgāme
asanketena	asaṅketena
sanghāṭimpi	saṅghāṭimpi
chahangehi	chahaṅgehi
sutasankāya	sutasaṅkāya
angarāgañca	aṅgarāgañca
vibhangāni	vibhaṅgāni
sanghāṭiñca	saṅghāṭiñca
sankamaniyā	saṅkamaniyā
singālapitā	siṅgālapitā
sangahavāro	saṅgahavāro
lingapucchā	liṅgapucchā
janghabalaṃ	jaṅghabalaṃ
uttamangajo	uttamaṅgajo
vasangatoti	vasaṅgatoti
ākankhasīti	ākaṅkhasīti
evangottoti	evaṅgottoti
catūhangehi	catūhaṅgehi
kālankatoti	kālaṅkatoti
kālankatāti	kālaṅkatāti
vankakenapi	vaṅkakenapi
tadangenāti	tadaṅgenāti
asankhatañca	asaṅkhatañca
cankamatipi	caṅkamatipi
ādiccangena	ādiccaṅgena
evangottāti	evaṅgottāti
singālakāti	siṅgālakāti
dasahangehi	dasahaṅgehi
kulangāroti	kulaṅgāroti
sangāmesīti	saṅgāmesīti
asankhatoti	asaṅkhatoti
kālankatāpi	kālaṅkatāpi
pingiyānīti	piṅgiyānīti
bojjhangāti	bojjhaṅgāti
kālankatañca	kālaṅkatañca
gangāpeyyālī	gaṅgāpeyyālī
sayankatañca	sayaṅkatañca
abhisangīti	abhisaṅgīti
sankulikāti	saṅkulikāti
sangahitoti	saṅgahitoti
kāmangamoti	kāmaṅgamoti
sangahitāti	saṅgahitāti
parankatañca	paraṅkatañca
accankusova	accaṅkusova
kalingaroti	kaliṅgaroti
sabbasangaho	sabbasaṅgaho
satalingassa	sataliṅgassa
jālasankhāto	jālasaṅkhāto
devasanghena	devasaṅghena
nangalamahaṃ	naṅgalamahaṃ
katihangehi	katihaṅgehi
sanghādhīnā	saṅghādhīnā
sumangalāti	sumaṅgalāti
mahāsangāmaṃ	mahāsaṅgāmaṃ
ingālakuyāva	iṅgālakuyāva
sankamanīyaṃ	saṅkamanīyaṃ
sankārapuñjā	saṅkārapuñjā
mānasankhaye	mānasaṅkhaye
dhutangavaggo	dhutaṅgavaggo
gangāsotova	gaṅgāsotova
sanghabhinno	saṅghabhinno
ankusamādāya	aṅkusamādāya
attādānaanga	attādānaaṅga
sangatībhāvā	saṅgatībhāvā
sanghāṭivāsī	saṅghāṭivāsī
sanghikaññeva	saṅghikaññeva
sangāmetīti	saṅgāmetīti
āsankathāti	āsaṅkathāti
sankheyyakāro	saṅkheyyakāro
angulicchinno	aṅgulicchinno
bojjhangāni	bojjhaṅgāni
sangamaticca	saṅgamaticca
suttasangaho	suttasaṅgaho
udakasangahe	udakasaṅgahe
ankuravatthu	aṅkuravatthu
nangalīsāti	naṅgalīsāti
sanghādhīno	saṅghādhīno
sattangulaṃ	sattaṅgulaṃ
sanghasuṭṭhu	saṅghasuṭṭhu
cūḷasangāmaṃ	cūḷasaṅgāmaṃ
cankamatīti	caṅkamatīti
mātangaputto	mātaṅgaputto
aṭṭhahangehi	aṭṭhahaṅgehi
sattahangehi	sattahaṅgehi
caṭṭhangikaṃ	caṭṭhaṅgikaṃ
appabhanguñca	appabhaṅguñca
singālakaṃyeva	siṅgālakaṃyeva
sankhatametaṃ	saṅkhatametaṃ
asayankārañca	asayaṅkārañca
pāṭikankhoti	pāṭikaṅkhoti
sanghagatampi	saṅghagatampi
sanghāṭikampi	saṅghāṭikampi
singhāṭakoti	siṅghāṭakoti
kankhanīyeva	kaṅkhanīyeva
tankhaṇikāyapi	taṅkhaṇikāyapi
sangāmetunti	saṅgāmetunti
atthangamoti	atthaṅgamoti
ākankheyyāti	ākaṅkheyyāti
pañcahangehi	pañcahaṅgehi
nikkankhvāhaṃ	nikkaṅkhvāhaṃ
pañcangikañca	pañcaṅgikañca
aṭṭhangikañca	aṭṭhaṅgikañca
appabhangūti	appabhaṅgūti
cankamantopi	caṅkamantopi
ākankheyyuñce	ākaṅkheyyuñce
cankamantova	caṅkamantova
sankhāresupi	saṅkhāresupi
sāngaṇānaṃyeva	sāṅgaṇānaṃyeva
ekangahīnāti	ekaṅgahīnāti
cangavāranti	caṅgavāranti
ucchangehipi	ucchaṅgehipi
aparankārañca	aparaṅkārañca
sankhārānañce	saṅkhārānañce
sanghikenāti	saṅghikenāti
pubbangamāti	pubbaṅgamāti
upasankamīti	upasaṅkamīti
sangaṇhāsīti	saṅgaṇhāsīti
sanghassāhaṃ	saṅghassāhaṃ
pāṭikankhāti	pāṭikaṅkhāti
langhakānampi	laṅghakānampi
angulimāloti	aṅgulimāloti
atthangamañca	atthaṅgamañca
singhāṭakepi	siṅghāṭakepi
sumangalamātā	sumaṅgalamātā
nidānasangaho	nidānasaṅgaho
vatthusangaho	vatthusaṅgaho
singālapitiko	siṅgālapitiko
sanghāṭikaṇṇe	saṅghāṭikaṇṇe
sankaccikāti	saṅkaccikāti
vinayasangīti	vinayasaṅgīti
titthiyalinge	titthiyaliṅge
pānīyasankhaṃ	pānīyasaṅkhaṃ
cankamantīti	caṅkamantīti
sangharājīti	saṅgharājīti
āvāsikalingaṃ	āvāsikaliṅgaṃ
pārangamanīyā	pāraṅgamanīyā
sangītinidāna	saṅgītinidāna
suttavibhango	suttavibhaṅgo
sangahitavāro	saṅgahitavāro
sankiccathero	saṅkiccathero
asankhatanti	asaṅkhatanti
byasanangato	byasanaṅgato
rajanuḷunkaṃ	rajanuḷuṅkaṃ
sangahitavāra	saṅgahitavāra
buddhasanghaṃ	buddhasaṅghaṃ
āpattisangaho	āpattisaṅgaho
sarabhangoti	sarabhaṅgoti
dūteyyangāni	dūteyyaṅgāni
dhutangavagga	dhutaṅgavagga
sakyapungavaṃ	sakyapuṅgavaṃ
paṭisankhāpi	paṭisaṅkhāpi
angulicchinnaṃ	aṅgulicchinnaṃ
sanghātanikaṃ	saṅghātanikaṃ
parisankitosi	parisaṅkitosi
anangaṇānaṃyeva	anaṅgaṇānaṃyeva
katiangikanti	katiaṅgikanti
asankaccikāti	asaṅkaccikāti
sankhārānaṃyeva	saṅkhārānaṃyeva
sankārakūṭeva	saṅkārakūṭeva
kālankiriyāti	kālaṅkiriyāti
ākankhamānoti	ākaṅkhamānoti
ākankhamānova	ākaṅkhamānova
nanguṭṭhenapi	naṅguṭṭhenapi
sanghabhedoti	saṅghabhedoti
cingulakenapi	ciṅgulakenapi
vankaghastova	vaṅkaghastova
sankhārānāhaṃ	saṅkhārānāhaṃ
pañcangikanti	pañcaṅgikanti
sankiliṭṭhañca	saṅkiliṭṭhañca
mahānāmangena	mahānāmaṅgena
alankarothāti	alaṅkarothāti
cupasankamitā	cupasaṅkamitā
nīlālankārāti	nīlālaṅkārāti
tassangaṇassa	tassaṅgaṇassa
āṇisanghāṭova	āṇisaṅghāṭova
sankhittenapi	saṅkhittenapi
pangacīrenapi	paṅgacīrenapi
sāmaññanganti	sāmaññaṅganti
rangamajjhepi	raṅgamajjhepi
sankhasaddoti	saṅkhasaddoti
sangaṇhantīti	saṅgaṇhantīti
cankamantanti	caṅkamantanti
appātankatañca	appātaṅkatañca
vibhangakovida	vibhaṅgakovida
mangalatthāya	maṅgalatthāya
vibhangakovido	vibhaṅgakovido
sangamupaccagā	saṅgamupaccagā
sankhānasippaṃ	saṅkhānasippaṃ
sankhāraparamā	saṅkhāraparamā
angārakāsuṃva	aṅgārakāsuṃva
kālankatesupi	kālaṅkatesupi
cankameyyanti	caṅkameyyanti
sanghepavāraṇā	saṅghepavāraṇā
āgantukalingaṃ	āgantukaliṅgaṃ
pacchākankhati	pacchākaṅkhati
puggalasangaho	puggalasaṅgaho
sabbālankāraṃ	sabbālaṅkāraṃ
sangāmasīseva	saṅgāmasīseva
hingusipāṭikaṃ	hiṅgusipāṭikaṃ
vipattisangaho	vipattisaṅgaho
sankasāyantiyo	saṅkasāyantiyo
gāthāsangaṇika	gāthāsaṅgaṇika
uttaribhangāni	uttaribhaṅgāni
parisankasīti	parisaṅkasīti
sanghalābhassa	saṅghalābhassa
sankappayantāya	saṅkappayantāya
pabbajitalinge	pabbajitaliṅge
pubbangamanti	pubbaṅgamanti
dukkhasankhayo	dukkhasaṅkhayo
jangheyyakampi	jaṅgheyyakampi
sangheuposatho	saṅgheuposatho
khandhasangaho	khandhasaṅgaho
lingasaṃvāsakā	liṅgasaṃvāsakā
ankusaggahoti	aṅkusaggahoti
sanghagarukena	saṅghagarukena
upaḍḍhasunkena	upaḍḍhasuṅkena
sāvakasanghoti	sāvakasaṅghoti
odātālankārāti	odātālaṅkārāti
vacīsankhāroti	vacīsaṅkhāroti
sangāmeyyāmāti	saṅgāmeyyāmāti
maggabojjhangaṃ	maggabojjhaṅgaṃ
sanghamajjheti	saṅghamajjheti
mudingasaddampi	mudiṅgasaddampi
sankāraggitveva	saṅkāraggitveva
mātangaraññeva	mātaṅgaraññeva
sangahetabboti	saṅgahetabboti
sankhalikāhīti	saṅkhalikāhīti
upasankamitāti	upasaṅkamitāti
susangahitāssa	susaṅgahitāssa
asankiliṭṭhāti	asaṅkiliṭṭhāti
uttaribhangampi	uttaribhaṅgampi
tunganāsikanti	tuṅganāsikanti
asankiliṭṭhoti	asaṅkiliṭṭhoti
yadākankhasīti	yadākaṅkhasīti
pāṭikankhinoti	pāṭikaṅkhinoti
sanghādisesoti	saṅghādisesoti
eṇeyyajanghoti	eṇeyyajaṅghoti
sunkadāyakaṃva	suṅkadāyakaṃva
sanghamajjhampi	saṅghamajjhampi
vinayasangītiyā	vinayasaṅgītiyā
sangāmessatīti	saṅgāmessatīti
bojjhangabalāni	bojjhaṅgabalāni
pavāraṇāsangaha	pavāraṇāsaṅgaha
vassikasanketaṃ	vassikasaṅketaṃ
pavāraṇāsangahe	pavāraṇāsaṅgahe
nānājanasangaho	nānājanasaṅgaho
vibhangasamaṇaṃ	vibhaṅgasamaṇaṃ
sankiliṭṭhamanā	saṅkiliṭṭhamanā
langhetumicchasi	laṅghetumicchasi
sangāyissāmāti	saṅgāyissāmāti
akathankathīti	akathaṅkathīti
sangāmagataṃva	saṅgāmagataṃva
pavāraṇāsangaho	pavāraṇāsaṅgaho
sanghaṭṭamānāni	saṅghaṭṭamānāni
vācābhikankhāmi	vācābhikaṅkhāmi
sanghabhattampi	saṅghabhattampi
sanghamajjhepi	saṅghamajjhepi
upasankamatūti	upasaṅkamatūti
mangalamuttamaṃ	maṅgalamuttamaṃ
gāthāsangaṇikaṃ	gāthāsaṅgaṇikaṃ
kankhitamaññāsi	kaṅkhitamaññāsi
imehaṭṭhangehi	imehaṭṭhaṅgehi
sanghāṭikaṇṇena	saṅghāṭikaṇṇena
paṭisankhayantaṃ	paṭisaṅkhayantaṃ
sangāyeyyāmāti	saṅgāyeyyāmāti
sanghasobhanāti	saṅghasobhanāti
upasankamantūti	upasaṅkamantūti
uddhangāmininti	uddhaṅgāmininti
sanghasāmaggīti	saṅghasāmaggīti
anucankamantepi	anucaṅkamantepi
panābhikankhati	panābhikaṅkhati
sangāmāvacaroti	saṅgāmāvacaroti
bhikkhusanghoti	bhikkhusaṅghoti
sankhittamatthaṃ	saṅkhittamatthaṃ
angulimuddikāti	aṅgulimuddikāti
sammāsankappoti	sammāsaṅkappoti
cittasankappoti	cittasaṅkappoti
bhikkhusanghañca	bhikkhusaṅghañca
sammāsankappañce	sammāsaṅkappañce
sangāyissantīti	saṅgāyissantīti
bhikkhusangheti	bhikkhusaṅgheti
asankiliṭṭhanti	asaṅkiliṭṭhanti
sankhamuṇḍikampi	saṅkhamuṇḍikampi
sankilissantīti	saṅkilissantīti
upasankamitunti	upasaṅkamitunti
agadangārassapi	agadaṅgārassapi
vibhangapaṭipadā	vibhaṅgapaṭipadā
kārakasanghanti	kārakasaṅghanti
upasankamitvāti	upasaṅkamitvāti
sankiliṭṭhābhāti	saṅkiliṭṭhābhāti
singālakamātāti	siṅgālakamātāti
sankhānapañcamaṃ	saṅkhānapañcamaṃ
dhammasangahoti	dhammasaṅgahoti
yadābhikankhati	yadābhikaṅkhati
angapaccanganti	aṅgapaccaṅganti
sanghādisesanti	saṅghādisesanti
cābhisankharoti	cābhisaṅkharoti
sangāmessantīti	saṅgāmessantīti
asankhatagāmiñca	asaṅkhatagāmiñca
cittasankhāroti	cittasaṅkhāroti
yenakāmangamoti	yenakāmaṅgamoti
ākankhamānenāti	ākaṅkhamānenāti
upasankamantīti	upasaṅkamantīti
bhikkhusanghopi	bhikkhusaṅghopi
asankhyeyyānīti	asaṅkhyeyyānīti
alankammaniyeti	alaṅkammaniyeti
aparisankitanti	aparisaṅkitanti
dvangulakappoti	dvaṅgulakappoti
sanghādisesagāmī	saṅghādisesagāmī
tilasanguḷikāti	tilasaṅguḷikāti
ariyaṭṭhangikaṃ	ariyaṭṭhaṅgikaṃ
pavāraṇāsangahaṃ	pavāraṇāsaṅgahaṃ
ekangadassinoti	ekaṅgadassinoti
sankāradhānasmiṃ	saṅkāradhānasmiṃ
sankilissamānāse	saṅkilissamānāse
asanghaṭṭentena	asaṅghaṭṭentena
angārakāsusadisā	aṅgārakāsusadisā
cankamissantīti	caṅkamissantīti
sanghabhedakāpi	saṅghabhedakāpi
sanghabhedakathā	saṅghabhedakathā
vipattisangahena	vipattisaṅgahena
sankhārasantatiṃ	saṅkhārasantatiṃ
sankaccudakasāṭi	saṅkaccudakasāṭi
bojjhangabhāvanā	bojjhaṅgabhāvanā
ñātisanghasatāni	ñātisaṅghasatāni
cirasankiliṭṭhaṃ	cirasaṅkiliṭṭhaṃ
lingapātubhāvena	liṅgapātubhāvena
sanghādisesenāti	saṅghādisesenāti
mahāmigasanghoti	mahāmigasaṅghoti
idhūpasankantāti	idhūpasaṅkantāti
sanghāṭikattameva	saṅghāṭikattameva
tenupasankantoti	tenupasaṅkantoti
padhāniyangānīti	padhāniyaṅgānīti
tadanganibbutoti	tadaṅganibbutoti
bhikkhusanghaṃyeva	bhikkhusaṅghaṃyeva
micchāsankappoti	micchāsaṅkappoti
sankhāragatametaṃ	saṅkhāragatametaṃ
purisakhaḷunkāti	purisakhaḷuṅkāti
biḷangadutiyanti	biḷaṅgadutiyanti
candanangalikāti	candanaṅgalikāti
upasankameyyanti	upasaṅkameyyanti
bilangadutiyanti	bilaṅgadutiyanti
singīnikkhassāpi	siṅgīnikkhassāpi
appaṭisankhāyāti	appaṭisaṅkhāyāti
asitabyābhangiñca	asitabyābhaṅgiñca
aṭṭhangikassetaṃ	aṭṭhaṅgikassetaṃ
sanghupaṭṭhākoti	saṅghupaṭṭhākoti
bhikkhusanghanti	bhikkhusaṅghanti
upasankamanāyāti	upasaṅkamanāyāti
pāpasampavankoti	pāpasampavaṅkoti
sangharakkhitāti	saṅgharakkhitāti
sangharakkhitoti	saṅgharakkhitoti
tadatthangatanti	tadatthaṅgatanti
bilangathālikampi	bilaṅgathālikampi
aḍḍhapallankanti	aḍḍhapallaṅkanti
sanghanānākaraṇaṃ	saṅghanānākaraṇaṃ
aṭṭhangulaparamaṃ	aṭṭhaṅgulaparamaṃ
kankhamabhijānāmi	kaṅkhamabhijānāmi
adhikaraṇasangaho	adhikaraṇasaṅgaho
vitthārasankhepaṃ	vitthārasaṅkhepaṃ
avebhangiyavatthu	avebhaṅgiyavatthu
sanghabhedakavīso	saṅghabhedakavīso
singhāṭakabaddhaṃ	siṅghāṭakabaddhaṃ
idhūpasankamantā	idhūpasaṅkamantā
ahankārapasutāyaṃ	ahaṅkārapasutāyaṃ
odātamanasankappo	odātamanasaṅkappo
maggānaṭṭhangiko	maggānaṭṭhaṅgiko
sanghavavatthānaṃ	saṅghavavatthānaṃ
kusalankusaggaho	kusalaṅkusaggaho
kulankapādakanti	kulaṅkapādakanti
cankamanasālanti	caṅkamanasālanti
samuṭṭhānasangaho	samuṭṭhānasaṅgaho
ogayhaṭṭhangikaṃ	ogayhaṭṭhaṅgikaṃ
gatamāyusankhayaṃ	gatamāyusaṅkhayaṃ
ākankhamānachakka	ākaṅkhamānachakka
sankhatamaddhuvaṃ	saṅkhatamaddhuvaṃ
sanghamappameyyaṃ	saṅghamappameyyaṃ
sankhārāniccatañca	saṅkhārāniccatañca
sayananguṭṭhakena	sayanaṅguṭṭhakena
angapaccangānanti	aṅgapaccaṅgānanti
tadanganibbānanti	tadaṅganibbānanti
upasankamissatīti	upasaṅkamissatīti
lomasakangiyāsubho	lomasakaṅgiyāsubho
sankhāranirodhoti	saṅkhāranirodhoti
sangahavatthūnīti	saṅgahavatthūnīti
upasankamissāmīti	upasaṅkamissāmīti
sotāpattiyanganti	sotāpattiyaṅganti
asammataatthangatū	asammataatthaṅgatū
abhisankhareyyāti	abhisaṅkhareyyāti
bhikkhusanghenāti	bhikkhusaṅghenāti
nālankammaniyanti	nālaṅkammaniyanti
padhānasankhārāti	padhānasaṅkhārāti
theyyasankhātanti	theyyasaṅkhātanti
sankhāranirodhañca	saṅkhāranirodhañca
upasankamissāmāti	upasaṅkamissāmāti
sanghādisesassāti	saṅghādisesassāti
sanghasāmaggiyāti	saṅghasāmaggiyāti
asuddhaparisankito	asuddhaparisaṅkito
pavāraṇāsangahassa	pavāraṇāsaṅgahassa
aṭṭhikankalakuṭike	aṭṭhikaṅkalakuṭike
migasanghanisevitā	migasaṅghanisevitā
sanghabhedakavaggo	saṅghabhedakavaggo
sanghasāmaggīkathā	saṅghasāmaggīkathā
sangahitattabhāvo	saṅgahitattabhāvo
sanghabhedakavagga	saṅghabhedakavagga
upasankamitabboti	upasaṅkamitabboti
sandhisinghāṭakesu	sandhisiṅghāṭakesu
singīnikkhasavaṇṇo	siṅgīnikkhasavaṇṇo
piṭṭhasanghāṭameva	piṭṭhasaṅghāṭameva
sankiccattheragāthā	saṅkiccattheragāthā
sukhavedanāsamangī	sukhavedanāsamaṅgī
ākankhamānachakkaṃ	ākaṅkhamānachakkaṃ
sanghasāmaggiyoti	saṅghasāmaggiyoti
ākankhamānacatukka	ākaṅkhamānacatukka
sankhārapaccayāti	saṅkhārapaccayāti
paṭisankhānabalañca	paṭisaṅkhānabalañca
sankilesadhammaṃyeva	saṅkilesadhammaṃyeva
sankhārasamudayañca	saṅkhārasamudayañca
singālāṭānāṭiyakaṃ	siṅgālāṭānāṭiyakaṃ
satisambojjhangoti	satisambojjhaṅgoti
sangaṇikārāmassāti	saṅgaṇikārāmassāti
aparājitasanghanti	aparājitasaṅghanti
sangaṇikārāmadevatā	saṅgaṇikārāmadevatā
sotāpattiyangānīti	sotāpattiyaṅgānīti
ovādūpasankamanañca	ovādūpasaṅkamanañca
abhisankhareyyanti	abhisaṅkhareyyanti
bhikkhusanghassāti	bhikkhusaṅghassāti
angulipabbamattampi	aṅgulipabbamattampi
pītisambojjhangoti	pītisambojjhaṅgoti
tenupasankamantīti	tenupasaṅkamantīti
mudutalunanguliyassa	mudutalunaṅguliyassa
dukkhavedanāsamangī	dukkhavedanāsamaṅgī
itthālankāravaṇṇake	itthālaṅkāravaṇṇake
sangharakkhitatthero	saṅgharakkhitatthero
pakkhasankantesupi	pakkhasaṅkantesupi
kankhārevatasammato	kaṅkhārevatasammato
aṭṭhangamaggadharaṃ	aṭṭhaṅgamaggadharaṃ
ākankhamānacatukkaṃ	ākaṅkhamānacatukkaṃ
jarāmaraṇasanghāṭaṃ	jarāmaraṇasaṅghāṭaṃ
sammāsankappagocaro	sammāsaṅkappagocaro
pabbajjābhisankhāro	pabbajjābhisaṅkhāro
bhāvethaṭṭhangikaṃ	bhāvethaṭṭhaṅgikaṃ
sammāsankappagocarā	sammāsaṅkappagocarā
sankhārenupalippati	saṅkhārenupalippati
tenupasankameyyanti	tenupasaṅkameyyanti
paripuṇṇasankappāti	paripuṇṇasaṅkappāti
sankhāresūpasantesu	saṅkhāresūpasantesu
kalyāṇasampavankoti	kalyāṇasampavaṅkoti
paṭisankhareyyāmāti	paṭisaṅkhareyyāmāti
anguttarasamāyutāti	aṅguttarasamāyutāti
pāpasampavankassāti	pāpasampavaṅkassāti
pāṭikankhitabbānīti	pāṭikaṅkhitabbānīti
dhammavinayasangītiṃ	dhammavinayasaṅgītiṃ
cankamanajantāgharaṃ	caṅkamanajantāgharaṃ
micchāsankappagocarā	micchāsaṅkappagocarā
bhikkhunisangheneva	bhikkhunisaṅgheneva
sanghabhedakapañcamo	saṅghabhedakapañcamo
sanghādisesakaṇḍādi	saṅghādisesakaṇḍādi
aṭṭhisanghātaghaṭito	aṭṭhisaṅghātaghaṭito
caturangulavitthataṃ	caturaṅgulavitthataṃ
aṭṭhangamaggamariyaṃ	aṭṭhaṅgamaggamariyaṃ
ākankhamānacuddasaka	ākaṅkhamānacuddasaka
bhikkhunisanghenāti	bhikkhunisaṅghenāti
sangāmāvacarenupāli	saṅgāmāvacarenupāli
caturangulapacchimaṃ	caturaṅgulapacchimaṃ
ovādūpasankamananti	ovādūpasaṅkamananti
bojjhangaṭṭhangikaṃ	bojjhaṅgaṭṭhaṅgikaṃ
uttarāsangasatānīti	uttarāsaṅgasatānīti
vigatarajamanangaṇaṃ	vigatarajamanaṅgaṇaṃ
tenupasankamissāmīti	tenupasaṅkamissāmīti
vīriyasambojjhangoti	vīriyasambojjhaṅgoti
tenupasankamissāmāti	tenupasaṅkamissāmāti
tenupasankameyyāmāti	tenupasaṅkameyyāmāti
sankhatalakkhaṇānīti	saṅkhatalakkhaṇānīti
singīnikkhasatassāpi	siṅgīnikkhasatassāpi
sugatigamanasankhātaṃ	sugatigamanasaṅkhātaṃ
tevīsasanghādisesānaṃ	tevīsasaṅghādisesānaṃ
vassaṃvuṭṭhasanghassa	vassaṃvuṭṭhasaṅghassa
sītibhāvābhikankhinī	sītibhāvābhikaṅkhinī
ākankhamānacuddasakaṃ	ākaṅkhamānacuddasakaṃ
navaggahamankusaggaho	navaggahamaṅkusaggaho
diṭṭhasutaparisankito	diṭṭhasutaparisaṅkito
sanghabhedakacatuttho	saṅghabhedakacatuttho
kalyāṇasampavankatāti	kalyāṇasampavaṅkatāti
upekkhāsambojjhangoti	upekkhāsambojjhaṅgoti
asankhatalakkhaṇānīti	asaṅkhatalakkhaṇānīti
samādhisambojjhangoti	samādhisambojjhaṅgoti
bhavasankhāramavassaji	bhavasaṅkhāramavassaji
kammanidānasankhayoti	kammanidānasaṅkhayoti
katangasamannāgatanti	kataṅgasamannāgatanti
angīrasassappaṭimassa	aṅgīrasassappaṭimassa
apaduṭṭhamanasankappo	apaduṭṭhamanasaṅkappo
sanghabhedakakkhandhako	saṅghabhedakakkhandhako
sanghabhedakakkhandhaka	saṅghabhedakakkhandhaka
diṭṭhasutaparisankitaṃ	diṭṭhasutaparisaṅkitaṃ
accharāsanghātamattampi	accharāsaṅghātamattampi
pañcangasamannāgatanti	pañcaṅgasamannāgatanti
sanghāṭikaṇṇaggahaṇampi	saṅghāṭikaṇṇaggahaṇampi
tadangadiṭṭhadhammikena	tadaṅgadiṭṭhadhammikena
suddhasankhārapuñjoyaṃ	suddhasaṅkhārapuñjoyaṃ
bojjhangasamādhibhāvanā	bojjhaṅgasamādhibhāvanā
sanghādisesāpattipucchā	saṅghādisesāpattipucchā
passaddhisambojjhangoti	passaddhisambojjhaṅgoti
sanghādisesāpattikkhandho	saṅghādisesāpattikkhandho
sanghāṭipattacīvaradharo	saṅghāṭipattacīvaradharo
sanghabhedakupajjhāyena	saṅghabhedakupajjhāyena
gaṇācariyasāvakasanghāti	gaṇācariyasāvakasaṅghāti
kankhāvitaraṇavisuddhiñce	kaṅkhāvitaraṇavisuddhiñce
angulipabbatemanamattampi	aṅgulipabbatemanamattampi
dakkhiṇāvibhangasuttanti	dakkhiṇāvibhaṅgasuttanti
papañcasaññāsankhāpahānaṃ	papañcasaññāsaṅkhāpahānaṃ
sanghādisesāpattikkhandhena	saṅghādisesāpattikkhandhena
sankhapaṇavadindimasaddampi	saṅkhapaṇavadindimasaddampi
dhammavicayasambojjhangoti	dhammavicayasambojjhaṅgoti
sankhatamabhisankharontīti	saṅkhatamabhisaṅkharontīti
khaṇḍaphullapaṭisankharaṇaṃ	khaṇḍaphullapaṭisaṅkharaṇaṃ
atirekadvangulapabbaparamaṃ	atirekadvaṅgulapabbaparamaṃ
adukkhamasukhavedanāsamangī	adukkhamasukhavedanāsamaṅgī
dhammānupassanābojjhangapabba	dhammānupassanābojjhaṅgapabba
sankhāradhāturāgavinibandhañca	saṅkhāradhāturāgavinibandhañca
sasankhāraniggayhavāritagatoti	sasaṅkhāraniggayhavāritagatoti
uccālingapāṇakadaṭṭhūpatthambheti	uccāliṅgapāṇakadaṭṭhūpatthambheti
sabbaahankāramamankāramānānusayānaṃ	sabbaahaṅkāramamaṅkāramānānusayānaṃ
sankhārasamāpattipattabbamakkhāyati	saṅkhārasamāpattipattabbamakkhāyati
sankhārāvasesasamāpattipattabbametaṃ	saṅkhārāvasesasamāpattipattabbametaṃ
mahātaṇhājālataṇhāsanghāṭappaṭimukkanti	mahātaṇhājālataṇhāsaṅghāṭappaṭimukkanti
gangātīriyo	gaṅgātīriyo
huṃhunko	huṃhuṅko
angaṃtveva	aṅgaṃtveva
anganteva	aṅganteva
ekasanghampi	ekasaṅghampi
appevangāni	appevaṅgāni
sasangāmeva	sasaṅgāmeva
vankakotveva	vaṅkakotveva
sanghañcassa	saṅghañcassa
mahāranganāma	mahāraṅganāma
sanghassevetaṃ	saṅghassevetaṃ
antovankagato	antovaṅkagato
sattanganti	sattaṅganti
asankamanīyā	asaṅkamanīyā
sankappotipi	saṅkappotipi
vibhangañcāti	vibhaṅgañcāti
susangītāvuso	susaṅgītāvuso
singiloṇakappo	siṅgiloṇakappo
vaggasangahoti	vaggasaṅgahoti
sankhamuttāva	saṅkhamuttāva
bhangodakanti	bhaṅgodakanti
kāḷanginiṃva	kāḷaṅginiṃva
ekasanghātampi	ekasaṅghātampi
lingapucchāti	liṅgapucchāti
kāmasangasattā	kāmasaṅgasattā
sankhittañceva	saṅkhittañceva
kālankatotveva	kālaṅkatotveva
sankhārepāhaṃ	saṅkhārepāhaṃ
asankamaniyāyo	asaṅkamaniyāyo
hirimangalanāmo	hirimaṅgalanāmo
sangāhaṇāhetuṃ	saṅgāhaṇāhetuṃ
acirangoyoniyā	aciraṅgoyoniyā
lingādidassana	liṅgādidassana
sanghasammukhatā	saṅghasammukhatā
tankhaṇikāyapīti	taṅkhaṇikāyapīti
pañcahangehīti	pañcahaṅgehīti
sankhatametanti	saṅkhatametanti
suttavibhangeti	suttavibhaṅgeti
sanghapuggalañca	saṅghapuggalañca
tiṇṇakathankatho	tiṇṇakathaṅkatho
sanghāṭikaṇṇopi	saṅghāṭikaṇṇopi
navasangahavagga	navasaṅgahavagga
samathasangahoti	samathasaṅgahoti
navasangahavaggo	navasaṅgahavaggo
sankhanābhimayaṃ	saṅkhanābhimayaṃ
pabhankarātipi	pabhaṅkarātipi
rangakkhamañceva	raṅgakkhamañceva
mangalatthāyāti	maṅgalatthāyāti
angarāgamukharāgo	aṅgarāgamukharāgo
mahārangamahānāma	mahāraṅgamahānāma
mahārangamahānāmā	mahāraṅgamahānāmā
gonangulamigāyutā	gonaṅgulamigāyutā
yatasankappajjhāyi	yatasaṅkappajjhāyi
vibhangakovidāti	vibhaṅgakovidāti
suveṇīhilankataṃ	suveṇīhilaṅkataṃ
anguliaḷakaṇḍaraṃ	aṅguliaḷakaṇḍaraṃ
sapattangārokiri	sapattaṅgārokiri
dhankamivossajanti	dhaṅkamivossajanti
paccayasangahamūlā	paccayasaṅgahamūlā
mangalamuttamanti	maṅgalamuttamanti
anupajjhāyasanghena	anupajjhāyasaṅghena
angarāgamukharāgaṃ	aṅgarāgamukharāgaṃ
vangīsattheravatthu	vaṅgīsattheravatthu
aṭṭhinhārusanghāte	aṭṭhinhārusaṅghāte
upasankamanampāhaṃ	upasaṅkamanampāhaṃ
bhikkhusanghañcāti	bhikkhusaṅghañcāti
sanghañcupaṭṭhāsiṃ	saṅghañcupaṭṭhāsiṃ
ariyañcaṭṭhangikaṃ	ariyañcaṭṭhaṅgikaṃ
sangāmavijayotipi	saṅgāmavijayotipi
sankappaparatejitaṃ	saṅkappaparatejitaṃ
upasankamanampahaṃ	upasaṅkamanampahaṃ
sabbamahārangarattā	sabbamahāraṅgarattā
alankammaniyañceva	alaṅkammaniyañceva
dvecaturangagāminaṃ	dvecaturaṅgagāminaṃ
aparagāthāsangaṇika	aparagāthāsaṅgaṇika
sattasangappahīnassa	sattasaṅgappahīnassa
ambapallavasankāsaṃ	ambapallavasaṅkāsaṃ
saṃyojanasangasattā	saṃyojanasaṅgasattā
parankārūpasaṃhitā	paraṅkārūpasaṃhitā
cankamanavedikanti	caṅkamanavedikanti
sankhatamasubhanti	saṅkhatamasubhanti
sammāsankappampahaṃ	sammāsaṅkappampahaṃ
vehāsādupasankamiṃ	vehāsādupasaṅkamiṃ
mangaladosavippahīno	maṅgaladosavippahīno
dutiyagāthāsangaṇika	dutiyagāthāsaṅgaṇika
sanghanānākaraṇanti	saṅghanānākaraṇanti
bhikkhusanghassevetaṃ	bhikkhusaṅghassevetaṃ
sanghāṭirajūpavāhane	saṅghāṭirajūpavāhane
angulimālacoravatthu	aṅgulimālacoravatthu
singhāṭakabaddhanti	siṅghāṭakabaddhanti
disangamikādivatthu	disaṅgamikādivatthu
nāgasanghapurakkhato	nāgasaṅghapurakkhato
dutiyagāthāsangaṇikaṃ	dutiyagāthāsaṅgaṇikaṃ
saṃyojanasangasattakā	saṃyojanasaṅgasattakā
sanghāṭirajūpavāhanaṃ	saṅghāṭirajūpavāhanaṃ
katamangasamannāgataṃ	katamaṅgasamannāgataṃ
angulimālattheravatthu	aṅgulimālattheravatthu
devasanghapurakkhataṃ	devasaṅghapurakkhataṃ
sattavīsatisangahāti	sattavīsatisaṅgahāti
haricandanalittangiṃ	haricandanalittaṅgiṃ
sabbamahārangarattāni	sabbamahāraṅgarattāni
sankhittavitthārenapi	saṅkhittavitthārenapi
sankiccasāmaṇeravatthu	saṅkiccasāmaṇeravatthu
suladdhalābhasankhātaṃ	suladdhalābhasaṅkhātaṃ
samuṭṭhānasīsasankhepa	samuṭṭhānasīsasaṅkhepa
sabbasangamūlabandhanā	sabbasaṅgamūlabandhanā
samuṭṭhānasīsasankhepo	samuṭṭhānasīsasaṅkhepo
dhammaviññāṇamākankhaṃ	dhammaviññāṇamākaṅkhaṃ
bhikkhunisanghassevetaṃ	bhikkhunisaṅghassevetaṃ
ayosankusamāhataṭṭhānaṃ	ayosaṅkusamāhataṭṭhānaṃ
bhikkhuvibhangamahāvāro	bhikkhuvibhaṅgamahāvāro
adhiṭṭhitañcatthangate	adhiṭṭhitañcatthaṅgate
sanghuposathādippabheda	saṅghuposathādippabheda
vimuttisamādhipañcangikā	vimuttisamādhipañcaṅgikā
sanghabhattādianujānana	saṅghabhattādianujānana
upālisanghasāmaggīpucchā	upālisaṅghasāmaggīpucchā
ṭhapayitvāsandipallankaṃ	ṭhapayitvāsandipallaṅkaṃ
dutiyasanghabhedakavagga	dutiyasaṅghabhedakavagga
dutiyasanghabhedakavaggo	dutiyasaṅghabhedakavaggo
ariyamaṭṭhangikamañjasaṃ	ariyamaṭṭhaṅgikamañjasaṃ
diṭṭhasutaparisankitoti	diṭṭhasutaparisaṅkitoti
suppatiṭṭhitasankhātanti	suppatiṭṭhitasaṅkhātanti
sankhāranirodhañāṇakusalo	saṅkhāranirodhañāṇakusalo
nāccharāsanghātamattampi	nāccharāsaṅghātamattampi
vicikicchākankhāganthitaṃ	vicikicchākaṅkhāganthitaṃ
mahākammasaḷāyatanavibhangā	mahākammasaḷāyatanavibhaṅgā
sanghabhedaparisakkanavatthu	saṅghabhedaparisakkanavatthu
khaṇḍaphullapaṭisankharaṇamattena	khaṇḍaphullapaṭisaṅkharaṇamattena
gangāmahiyāyāti	gaṅgāmahiyāyāti
huṃhunkajātiko	huṃhuṅkajātiko
singiloṇakappoti	siṅgiloṇakappoti
sankhanābhimayanti	saṅkhanābhimayanti
kappantusankitelañca	kappantusaṅkitelañca
mahāsangāmañāpanāti	mahāsaṅgāmañāpanāti
maṇikanakabhūsitango	maṇikanakabhūsitaṅgo
nangalakulattheravatthu	naṅgalakulattheravatthu
pārājisanghathullaccaya	pārājisaṅghathullaccaya
mahārangarattavaddhikā	mahāraṅgarattavaddhikā
sanghapavāraṇādippabheda	saṅghapavāraṇādippabheda
paragangāpeyyālīvaṇṇiyato	paragaṅgāpeyyālīvaṇṇiyato
sanghikacīvaruppādakathā	saṅghikacīvaruppādakathā
bhikkhusanghassevetanti	bhikkhusaṅghassevetanti
tāmatamadasanghasuppahīnā	tāmatamadasaṅghasuppahīnā
diṭṭhasutaparisankitomhīti	diṭṭhasutaparisaṅkitomhīti
bālanakkhattasanghuṭṭhavatthu	bālanakkhattasaṅghuṭṭhavatthu
sanghāṭikhuramuṇḍabhikkhabhojī	saṅghāṭikhuramuṇḍabhikkhabhojī
papañcasanghātadukhādhivāhiniṃ	papañcasaṅghātadukhādhivāhiniṃ
sangharakkhitabhāgineyyattheravatthu	saṅgharakkhitabhāgineyyattheravatthu
khaṇḍaphullapaṭisankharaṇamattenapi	khaṇḍaphullapaṭisaṅkharaṇamattenapi
dhankamivossajantīti	dhaṅkamivossajantīti
navangakusumamālagīveyyaṃ	navaṅgakusumamālagīveyyaṃ
sanghebhinnecīvaruppādakathā	saṅghebhinnecīvaruppādakathā
bheravānangaṇākankheyyavatthaṃ	bheravānaṅgaṇākaṅkheyyavatthaṃ
sanghabhedeanāpattivassacchedavāra	saṅghabhedeanāpattivassacchedavāra
akankho	akaṅkho
akankhaṃ	akaṅkhaṃ
akankhī	akaṅkhī
akankhiṃ	akaṅkhiṃ
akathankathī	akathaṅkathī
akathankathi	akathaṅkathi
akathankathiṃ	akathaṅkathiṃ
akathankathissa	akathaṅkathissa
akusalasankappā	akusalasaṅkappā
akusalasankhātā	akusalasaṅkhātā
akotūhalamangaliko	akotūhalamaṅgaliko
agadangāraṃ	agadaṅgāraṃ
agadangārassa	agadaṅgārassa
aggankurakaṃ	aggaṅkurakaṃ
anka	aṅka
anko	aṅko
ankaṃ	aṅkaṃ
anke	aṅke
ankena	aṅkena
ankura	aṅkura
ankusaṃ	aṅkusaṃ
ankusebhi	aṅkusebhi
ankusehi	aṅkusehi
ankusagayhaṃ	aṅkusagayhaṃ
ankusagayhe	aṅkusagayhe
ankusaggaho	aṅkusaggaho
anga	aṅga
angaṃ	aṅgaṃ
angā	aṅgā
angāni	aṅgāni
ange	aṅge
angena	aṅgena
angehi	aṅgehi
angassa	aṅgassa
angānaṃ	aṅgānaṃ
angato	aṅgato
angesu	aṅgesu
ango	aṅgo
angako	aṅgako
angakaṃ	aṅgakaṃ
angajātaṃ	aṅgajātaṃ
angajāte	aṅgajāte
angajātena	aṅgajātena
angajātasāmantā	aṅgajātasāmantā
angaṇaṃ	aṅgaṇaṃ
angaṇā	aṅgaṇā
angaṇe	aṅgaṇe
angaṇassa	aṅgaṇassa
angaṇikabhāradvājattheragāthā	aṅgaṇikabhāradvājattheragāthā
angapaccangaṃ	aṅgapaccaṅgaṃ
angapaccangāni	aṅgapaccaṅgāni
angapaccange	aṅgapaccaṅge
angapaccangānaṃ	aṅgapaccaṅgānaṃ
angamagadhā	aṅgamagadhā
angamagadhānaṃ	aṅgamagadhānaṃ
angamangāni	aṅgamaṅgāni
angamangānusārino	aṅgamaṅgānusārino
angamāgadhakehi	aṅgamāgadhakehi
angarāga	aṅgarāga
angarāgo	aṅgarāgo
angarāgaṃ	aṅgarāgaṃ
angarājā	aṅgarājā
angasambhārā	aṅgasambhārā
angasutta	aṅgasutta
angavijjā	aṅgavijjā
angavijjātiracchānavijjāya	aṅgavijjātiracchānavijjāya
angāra	aṅgāra
angāraṃ	aṅgāraṃ
angārāni	aṅgārāni
angāre	aṅgāre
angārānaṃ	aṅgārānaṃ
angāresu	aṅgāresu
angārakaṭāhena	aṅgārakaṭāhena
angārakāsu	aṅgārakāsu
angārakāsuṃ	aṅgārakāsuṃ
angārakāsuyā	aṅgārakāsuyā
angārakāsūpamā	aṅgārakāsūpamā
angārathūpo	aṅgārathūpo
angārapabbataṃ	aṅgārapabbataṃ
angārino	aṅgārino
angiko	aṅgiko
angiṃ	aṅgiṃ
anginiṃ	aṅginiṃ
angīrasa	aṅgīrasa
angīraso	aṅgīraso
angīrasaṃ	aṅgīrasaṃ
angīrasassa	aṅgīrasassa
angīrasi	aṅgīrasi
anguṭṭhaṃ	aṅguṭṭhaṃ
anguṭṭhena	aṅguṭṭhena
anguṭṭhakena	aṅguṭṭhakena
anguṭṭhapadaṃ	aṅguṭṭhapadaṃ
anguttara	aṅguttara
anguttaranikāyo	aṅguttaranikāyo
anguttarāpo	aṅguttarāpo
anguttarāpānaṃ	aṅguttarāpānaṃ
anguttarāpesu	aṅguttarāpesu
angulaṃ	aṅgulaṃ
angule	aṅgule
angulesu	aṅgulesu
angulantarikāya	aṅgulantarikāya
anguli	aṅguli
anguliyo	aṅguliyo
anguliṃ	aṅguliṃ
anguliyā	aṅguliyā
angulīhi	aṅgulīhi
angulīnaṃ	aṅgulīnaṃ
angulipatodako	aṅgulipatodako
angulipatodake	aṅgulipatodake
angulipatodakena	aṅgulipatodakena
angulipatodakehi	aṅgulipatodakehi
angulipatodakasikkhāpada	aṅgulipatodakasikkhāpada
angulipatodakasikkhāpadaṃ	aṅgulipatodakasikkhāpadaṃ
angulipadāni	aṅgulipadāni
angulipabbatemanamatta	aṅgulipabbatemanamatta
angulipabbatemanamattaṃ	aṅgulipabbatemanamattaṃ
angulimāla	aṅgulimāla
angulimālo	aṅgulimālo
angulimālaṃ	aṅgulimālaṃ
angulimālena	aṅgulimālena
angulimālassa	aṅgulimālassa
angulimālattheragāthā	aṅgulimālattheragāthā
angulimālasutta	aṅgulimālasutta
angulimālasuttaṃ	aṅgulimālasuttaṃ
angulimuddikā	aṅgulimuddikā
angulimuddikaṃ	aṅgulimuddikaṃ
angulimuddika	aṅgulimuddika
accankuso	accaṅkuso
accharāgaṇasanghuṭṭhaṃ	accharāgaṇasaṅghuṭṭhaṃ
accharāsanghaparivuto	accharāsaṅghaparivuto
accharāsanghaparivutā	accharāsaṅghaparivutā
accharāsanghātamatta	accharāsaṅghātamatta
accharāsanghātamattaṃ	accharāsaṅghātamattaṃ
accharāsanghātavagga	accharāsaṅghātavagga
accharāsanghātavaggo	accharāsaṅghātavaggo
ajjhattikangasutta	ajjhattikaṅgasutta
aññasanghassa	aññasaṅghassa
aṭavisankopo	aṭavisaṅkopo
aṭavisankope	aṭavisaṅkope
aṭṭhangāni	aṭṭhaṅgāni
aṭṭhangehi	aṭṭhaṅgehi
aṭṭhangamagga	aṭṭhaṅgamagga
aṭṭhangamaggaṃ	aṭṭhaṅgamaggaṃ
aṭṭhangasamannāgato	aṭṭhaṅgasamannāgato
aṭṭhangasamannāgataṃ	aṭṭhaṅgasamannāgataṃ
aṭṭhangasamannāgate	aṭṭhaṅgasamannāgate
aṭṭhangasamannāgatassa	aṭṭhaṅgasamannāgatassa
aṭṭhangasamannāgatesu	aṭṭhaṅgasamannāgatesu
aṭṭhangasusamāgatā	aṭṭhaṅgasusamāgatā
aṭṭhangasusamāgataṃ	aṭṭhaṅgasusamāgataṃ
aṭṭhangiko	aṭṭhaṅgiko
aṭṭhangikaṃ	aṭṭhaṅgikaṃ
aṭṭhangike	aṭṭhaṅgike
aṭṭhangikena	aṭṭhaṅgikena
aṭṭhangikassa	aṭṭhaṅgikassa
aṭṭhangikasutta	aṭṭhaṅgikasutta
aṭṭhangupetaṃ	aṭṭhaṅgupetaṃ
aṭṭhangupetassa	aṭṭhaṅgupetassa
aṭṭhangula	aṭṭhaṅgula
aṭṭhangulaṃ	aṭṭhaṅgulaṃ
aṭṭhangulapādakaṃ	aṭṭhaṅgulapādakaṃ
aṭṭhanguli	aṭṭhaṅguli
aṭṭhamasanghādisesasikkhāpadaṃ	aṭṭhamasaṅghādisesasikkhāpadaṃ
aṭṭhikankala	aṭṭhikaṅkala
aṭṭhikankalo	aṭṭhikaṅkalo
aṭṭhikankalaṃ	aṭṭhikaṅkalaṃ
aṭṭhikankalūpamā	aṭṭhikaṅkalūpamā
aṭṭhikasankhalikaṃ	aṭṭhikasaṅkhalikaṃ
aṭṭhinkatvā	aṭṭhiṅkatvā
aṭṭhisanghāta	aṭṭhisaṅghāta
aḍḍhapallankaṃ	aḍḍhapallaṅkaṃ
atirekadvangulapabba	atirekadvaṅgulapabba
atirekadvangulapabbe	atirekadvaṅgulapabbe
atthangato	atthaṅgato
atthangatā	atthaṅgatā
atthangate	atthaṅgate
atthangatena	atthaṅgatena
atthangatassa	atthaṅgatassa
atthangatasaññī	atthaṅgatasaññī
atthangatasikkhāpada	atthaṅgatasikkhāpada
atthangatasikkhāpadaṃ	atthaṅgatasikkhāpadaṃ
atthangatū	atthaṅgatū
atthangamo	atthaṅgamo
atthangamā	atthaṅgamā
atthangamaṃ	atthaṅgamaṃ
atthangamāya	atthaṅgamāya
adhunākālankato	adhunākālaṅkato
adhobhāgangamanīyā	adhobhāgaṅgamanīyā
anangaṇo	anaṅgaṇo
anangaṇā	anaṅgaṇā
anangaṇaṃ	anaṅgaṇaṃ
anangaṇe	anaṅgaṇe
anangaṇassa	anaṅgaṇassa
anangaṇānaṃ	anaṅgaṇānaṃ
anangaṇasutta	anaṅgaṇasutta
anangaṇasuttaṃ	anaṅgaṇasuttaṃ
anatthangate	anatthaṅgate
anatthangatasaññī	anatthaṅgatasaññī
anabhāvankato	anabhāvaṅkato
anabhāvankatā	anabhāvaṅkatā
anabhāvankataṃ	anabhāvaṅkataṃ
anabhāvankatāni	anabhāvaṅkatāni
anabhāvankate	anabhāvaṅkate
anabhisankhacca	anabhisaṅkhacca
anabhisankharitvā	anabhisaṅkharitvā
anabhisankharonto	anabhisaṅkharonto
anabhisankharoto	anabhisaṅkharoto
analankatā	analaṅkatā
analankaritvā	analaṅkaritvā
anavajjasankhātā	anavajjasaṅkhātā
anāvilasankappo	anāvilasaṅkappo
anāvilasankappā	anāvilasaṅkappā
aniṭṭhangato	aniṭṭhaṅgato
aniṭṭhangatatā	aniṭṭhaṅgatatā
anucankamanti	anucaṅkamanti
anucankamante	anucaṅkamante
anucankamāmi	anucaṅkamāmi
anucankamissaṃ	anucaṅkamissaṃ
anucankamanaṃ	anucaṅkamanaṃ
anucankamantānaṃ	anucaṅkamantānaṃ
anucankamamāno	anucaṅkamamāno
anucankamamānā	anucaṅkamamānā
anucankamāpenti	anucaṅkamāpenti
anucankamiṃsu	anucaṅkamiṃsu
anucankamiṃ	anucaṅkamiṃ
anupasankanto	anupasaṅkanto
anupubbasankhārānaṃ	anupubbasaṅkhārānaṃ
anusampavankatā	anusampavaṅkatā
anussankī	anussaṅkī
antosunkaghāte	antosuṅkaghāte
apagatavankā	apagatavaṅkā
aparaaccharāsanghātavagga	aparaaccharāsaṅghātavagga
aparaaccharāsanghātavaggo	aparaaccharāsaṅghātavaggo
aparankāro	aparaṅkāro
aparankārā	aparaṅkārā
aparankāraṃ	aparaṅkāraṃ
aparājitasanghaṃ	aparājitasaṅghaṃ
apariyositasankappo	apariyositasaṅkappo
aparisankito	aparisaṅkito
aparisankitaṃ	aparisaṅkitaṃ
aparisankitassa	aparisaṅkitassa
apuññābhisankhāro	apuññābhisaṅkhāro
apuññābhisankhāraṃ	apuññābhisaṅkhāraṃ
appaṭisankhā	appaṭisaṅkhā
appaṭisankhāya	appaṭisaṅkhāya
appaduṭṭhamanasankappo	appaduṭṭhamanasaṅkappo
appabhangu	appabhaṅgu
appabhangū	appabhaṅgū
appabhanguṃ	appabhaṅguṃ
appātanko	appātaṅko
appātankaṃ	appātaṅkaṃ
appātankataṃ	appātaṅkataṃ
abyāpādasankappo	abyāpādasaṅkappo
abhikankhati	abhikaṅkhati
abhikankhāmi	abhikaṅkhāmi
abhikankhantaṃ	abhikaṅkhantaṃ
abhikankhamāno	abhikaṅkhamāno
abhikankhamānā	abhikaṅkhamānā
abhikankhinī	abhikaṅkhinī
abhikkhaṇātanko	abhikkhaṇātaṅko
abhidosakālankato	abhidosakālaṅkato
abhimangalasammatā	abhimaṅgalasammatā
abhisankhacca	abhisaṅkhacca
abhisankhato	abhisaṅkhato
abhisankhatā	abhisaṅkhatā
abhisankhataṃ	abhisaṅkhataṃ
abhisankhari	abhisaṅkhari
abhisankharitvā	abhisaṅkharitvā
abhisankharesi	abhisaṅkharesi
abhisankhareyya	abhisaṅkhareyya
abhisankhareyyaṃ	abhisaṅkhareyyaṃ
abhisankharoti	abhisaṅkharoti
abhisankharonti	abhisaṅkharonti
abhisankhāro	abhisaṅkhāro
abhisankhārassa	abhisaṅkhārassa
abhisankhārikaṃ	abhisaṅkhārikaṃ
abhisankhāresi	abhisaṅkhāresi
abhisankhāsi	abhisaṅkhāsi
abhisankhāsiṃ	abhisaṅkhāsiṃ
abhisangī	abhisaṅgī
abhisangi	abhisaṅgi
amankubhūto	amaṅkubhūto
ayosanku	ayosaṅku
ayosankū	ayosaṅkū
ayosankunā	ayosaṅkunā
ayosinghāṭakaṃ	ayosiṅghāṭakaṃ
araṇavibhangaṃ	araṇavibhaṅgaṃ
araṇavibhangassa	araṇavibhaṅgassa
araṇavibhangasutta	araṇavibhaṅgasutta
araṇavibhangasuttaṃ	araṇavibhaṅgasuttaṃ
ariyaaṭṭhangikamagga	ariyaaṭṭhaṅgikamagga
ariyaaṭṭhangikamaggesu	ariyaaṭṭhaṅgikamaggesu
ariyamaggasamangino	ariyamaggasamaṅgino
ariyasanghassa	ariyasaṅghassa
alankato	alaṅkato
alankatā	alaṅkatā
alankataṃ	alaṅkataṃ
alankate	alaṅkate
alankatappaṭiyattā	alaṅkatappaṭiyattā
alankammaniyaṃ	alaṅkammaniyaṃ
alankammaniye	alaṅkammaniye
alankarā	alaṅkarā
alankarotha	alaṅkarotha
alankara	alaṅkara
alankāro	alaṅkāro
alankāraṃ	alaṅkāraṃ
alankārena	alaṅkārena
alankārānaṃ	alaṅkārānaṃ
alankārānuppadānena	alaṅkārānuppadānena
alankārūpavicārā	alaṅkārūpavicārā
alamariyasankhātā	alamariyasaṅkhātā
asankaccika	asaṅkaccika
asankaccikā	asaṅkaccikā
asankaccikāya	asaṅkaccikāya
asankaccikasikkhāpada	asaṅkaccikasikkhāpada
asankiṇṇā	asaṅkiṇṇā
asankiṇṇaṃ	asaṅkiṇṇaṃ
asankiṇṇāni	asaṅkiṇṇāni
asankiṇṇapubbā	asaṅkiṇṇapubbā
asankiṇṇapubbaṃ	asaṅkiṇṇapubbaṃ
asankiṇṇapubbāni	asaṅkiṇṇapubbāni
asankiliṭṭha	asaṅkiliṭṭha
asankiliṭṭho	asaṅkiliṭṭho
asankiliṭṭhā	asaṅkiliṭṭhā
asankiliṭṭhaṃ	asaṅkiliṭṭhaṃ
asankiliṭṭhe	asaṅkiliṭṭhe
asankiliṭṭhacitto	asaṅkiliṭṭhacitto
asankiliṭṭhacittā	asaṅkiliṭṭhacittā
asankuppaṃ	asaṅkuppaṃ
asankhato	asaṅkhato
asankhatā	asaṅkhatā
asankhataṃ	asaṅkhataṃ
asankhatassa	asaṅkhatassa
asankhatagāmimaggo	asaṅkhatagāmimaggo
asankhatagāmiṃ	asaṅkhatagāmiṃ
asankhatalakkhaṇāni	asaṅkhatalakkhaṇāni
asankhatalakkhaṇāna	asaṅkhatalakkhaṇāna
asankhatalakkhaṇasutta	asaṅkhatalakkhaṇasutta
asankhatasaṃyuttaṃ	asaṅkhatasaṃyuttaṃ
asankhatasaṃyuttassa	asaṅkhatasaṃyuttassa
asankhatasutta	asaṅkhatasutta
asankhatādhātu	asaṅkhatādhātu
asankhatārammaṇā	asaṅkhatārammaṇā
asankharāno	asaṅkharāno
asankhāditvā	asaṅkhāditvā
asankhāro	asaṅkhāro
asankhārā	asaṅkhārā
asankhāraṃ	asaṅkhāraṃ
asankhāraparinibbāyī	asaṅkhāraparinibbāyī
asankhāraparinibbāyissa	asaṅkhāraparinibbāyissa
asankhittaṃ	asaṅkhittaṃ
asankheyyaṃ	asaṅkheyyaṃ
asankheyyā	asaṅkheyyā
asankheyyesu	asaṅkheyyesu
asankheyyo	asaṅkheyyo
asankhyeyyo	asaṅkhyeyyo
asankhyeyyāni	asaṅkhyeyyāni
asankhyeyyāna	asaṅkhyeyyāna
asanga	asaṅga
asangacārī	asaṅgacārī
asangacārino	asaṅgacārino
asangati	asaṅgati
asangamānaso	asaṅgamānaso
asangamānasā	asaṅgamānasā
asangahitāni	asaṅgahitāni
asangahitattā	asaṅgahitattā
asamangī	asamaṅgī
asamāhitasankappo	asamāhitasaṅkappo
asayankāro	asayaṅkāro
asayankārā	asayaṅkārā
asayankāraṃ	asayaṅkāraṃ
asitabyābhangiṃ	asitabyābhaṅgiṃ
asucisankassarasamācāro	asucisaṅkassarasamācāro
asucisankassarasamācāraṃ	asucisaṅkassarasamācāraṃ
asucisankassarasamācārassa	asucisaṅkassarasamācārassa
asucisankhāto	asucisaṅkhāto
asucisankhātā	asucisaṅkhātā
asurasangāme	asurasaṅgāme
asevitabbasankhātā	asevitabbasaṅkhātā
assakhaḷunko	assakhaḷuṅko
assakhaḷunkā	assakhaḷuṅkā
assakhaḷunke	assakhaḷuṅke
assakhaḷunkassa	assakhaḷuṅkassa
assakhaḷunkasutta	assakhaḷuṅkasutta
avanka	avaṅka
avankā	avaṅkā
avankattā	avaṅkattā
avangaṃ	avaṅgaṃ
avassikasankete	avassikasaṅkete
avitiṇṇakankho	avitiṇṇakaṅkho
avitiṇṇakankhaṃ	avitiṇṇakaṅkhaṃ
avihiṃsāsankappo	avihiṃsāsaṅkappo
avihiṃsāsankappaṃ	avihiṃsāsaṅkappaṃ
avebhangiya	avebhaṅgiya
avebhangiyaṃ	avebhaṅgiyaṃ
avebhangiyāni	avebhaṅgiyāni
ahankāra	ahaṅkāra
ahankārā	ahaṅkārā
ahankāramamankāramānānusayo	ahaṅkāramamaṅkāramānānusayo
ahankāramamankāramānānusayā	ahaṅkāramamaṅkāramānānusayā
ahankāramamankāramānānusayānaṃ	ahaṅkāramamaṅkāramānānusayānaṃ
ahankāramamankāramānāpagataṃ	ahaṅkāramamaṅkāramānāpagataṃ
ākankhati	ākaṅkhati
ākankhanti	ākaṅkhanti
ākankhasi	ākaṅkhasi
ākankhatha	ākaṅkhatha
ākankhāmi	ākaṅkhāmi
ākankhāma	ākaṅkhāma
ākankhe	ākaṅkhe
ākankha	ākaṅkha
ākankheyya	ākaṅkheyya
ākankheyyuṃ	ākaṅkheyyuṃ
ākankheyyāsi	ākaṅkheyyāsi
ākankhissati	ākaṅkhissati
ākankhissasi	ākaṅkhissasi
ākankhanta	ākaṅkhanta
ākankhaṃ	ākaṅkhaṃ
ākankhantā	ākaṅkhantā
ākankhā	ākaṅkhā
ākankhamāna	ākaṅkhamāna
ākankhamāno	ākaṅkhamāno
ākankhamānā	ākaṅkhamānā
ākankhamānena	ākaṅkhamānena
ākankhamānānaṃ	ākaṅkhamānānaṃ
ākankhasutta	ākaṅkhasutta
ākankhavagga	ākaṅkhavagga
ākankhavaggo	ākaṅkhavaggo
ākankhi	ākaṅkhi
ākankho	ākaṅkho
ākankhiṃ	ākaṅkhiṃ
ākankhitaṃ	ākaṅkhitaṃ
ākankhiyehi	ākaṅkhiyehi
ākankheyyā	ākaṅkheyyā
ākankheyyasutta	ākaṅkheyyasutta
ākankheyyasuttaṃ	ākaṅkheyyasuttaṃ
āṇisanghāṭo	āṇisaṅghāṭo
ātankaphassena	ātaṅkaphassena
āneñjābhisankhāro	āneñjābhisaṅkhāro
āneñjābhisankhāraṃ	āneñjābhisaṅkhāraṃ
āmisasangaho	āmisasaṅgaho
āyusankhayā	āyusaṅkhayā
āyusankhayaṃ	āyusaṅkhayaṃ
āyusankhāro	āyusaṅkhāro
āyusankhārā	āyusaṅkhārā
āyusankhāraṃ	āyusaṅkhāraṃ
āyusankhāre	āyusaṅkhāre
āyusankhāraossajjana	āyusaṅkhāraossajjana
āyusankhārossajjanasutta	āyusaṅkhārossajjanasutta
āraññikangaṃ	āraññikaṅgaṃ
ālingeyya	āliṅgeyya
ālingitvā	āliṅgitvā
ālingetvā	āliṅgetvā
āsankatha	āsaṅkatha
āsankamāno	āsaṅkamāno
āsankī	āsaṅkī
ingālaku	iṅgālaku
ingālakuyā	iṅgālakuyā
ingha	iṅgha
icchānangalaṃ	icchānaṅgalaṃ
icchānangale	icchānaṅgale
icchānangalako	icchānaṅgalako
icchānangalakā	icchānaṅgalakā
icchānangalasutta	icchānaṅgalasutta
icchānangalavanasaṇḍo	icchānaṅgalavanasaṇḍo
icchānangalavanasaṇḍe	icchānaṅgalavanasaṇḍe
itthālankāra	itthālaṅkāra
itthālankāro	itthālaṅkāro
itthālankāraṃ	itthālaṅkāraṃ
itthālankārasikkhāpada	itthālaṅkārasikkhāpada
itthipurisalingapātubhāva	itthipurisaliṅgapātubhāva
itthilingaṃ	itthiliṅgaṃ
iddhābhisankhāraṃ	iddhābhisaṅkhāraṃ
idhūpasankanta	idhūpasaṅkanta
idhūpasankanto	idhūpasaṅkanto
idhūpasankantā	idhūpasaṅkantā
idhūpasankantāni	idhūpasaṅkantāni
indriyabalabojjhangā	indriyabalabojjhaṅgā
isisanghanisevito	isisaṅghanisevito
isisanghanisevitaṃ	isisaṅghanisevitaṃ
uccangamāyo	uccaṅgamāyo
uccālingapāṇakā	uccāliṅgapāṇakā
uccālingapāṇakadaṭṭha	uccāliṅgapāṇakadaṭṭha
uccālingapāṇakadaṭṭhena	uccāliṅgapāṇakadaṭṭhena
uccālingapāṇakadaṭṭhūpatthambhe	uccāliṅgapāṇakadaṭṭhūpatthambhe
ucchangaṃ	ucchaṅgaṃ
ucchange	ucchaṅge
ucchangehi	ucchaṅgehi
ucchangapañño	ucchaṅgapañño
ujjangalanagarakaṃ	ujjaṅgalanagarakaṃ
ujjangalanagarake	ujjaṅgalanagarake
uttamanga	uttamaṅga
uttamange	uttamaṅge
uttarāsango	uttarāsaṅgo
uttarāsangaṃ	uttarāsaṅgaṃ
uttarāsangena	uttarāsaṅgena
uttarāsangehi	uttarāsaṅgehi
uttarāsangassa	uttarāsaṅgassa
uttarāsangasatāni	uttarāsaṅgasatāni
uttarāsangasatehi	uttarāsaṅgasatehi
uttarāsangasatāna	uttarāsaṅgasatāna
uttaribhanga	uttaribhaṅga
uttaribhangaṃ	uttaribhaṅgaṃ
uttaribhange	uttaribhaṅge
uttaribhangena	uttaribhaṅgena
uddesavibhangaṃ	uddesavibhaṅgaṃ
uddesavibhangasutta	uddesavibhaṅgasutta
uddesavibhangasuttaṃ	uddesavibhaṅgasuttaṃ
uddhangamā	uddhaṅgamā
uddhangāminiṃ	uddhaṅgāminiṃ
upadhisankhaye	upadhisaṅkhaye
uparibhāgangamanīyā	uparibhāgaṅgamanīyā
upasankanto	upasaṅkanto
upasankamati	upasaṅkamati
upasankamanti	upasaṅkamanti
upasankamante	upasaṅkamante
upasankamatha	upasaṅkamatha
upasankamāmi	upasaṅkamāmi
upasankamatu	upasaṅkamatu
upasankamantu	upasaṅkamantu
upasankameyya	upasaṅkameyya
upasankameyyuṃ	upasaṅkameyyuṃ
upasankameyyāsi	upasaṅkameyyāsi
upasankameyyāma	upasaṅkameyyāma
upasankameyyaṃ	upasaṅkameyyaṃ
upasankamissati	upasaṅkamissati
upasankamissanti	upasaṅkamissanti
upasankamissasi	upasaṅkamissasi
upasankamissāmi	upasaṅkamissāmi
upasankamissāma	upasaṅkamissāma
upasankamana	upasaṅkamana
upasankamanaṃ	upasaṅkamanaṃ
upasankamanassa	upasaṅkamanassa
upasankamanāya	upasaṅkamanāya
upasankamanto	upasaṅkamanto
upasankamantā	upasaṅkamantā
upasankamantī	upasaṅkamantī
upasankamantena	upasaṅkamantena
upasankamato	upasaṅkamato
upasankami	upasaṅkami
upasankamī	upasaṅkamī
upasankamiṃsu	upasaṅkamiṃsu
upasankamiṃ	upasaṅkamiṃ
upasankamimhā	upasaṅkamimhā
upasankamitabbo	upasaṅkamitabbo
upasankamitabbā	upasaṅkamitabbā
upasankamitabbaṃ	upasaṅkamitabbaṃ
upasankamitabbāni	upasaṅkamitabbāni
upasankamitā	upasaṅkamitā
upasankamitāro	upasaṅkamitāro
upasankamita	upasaṅkamita
upasankamitukāmo	upasaṅkamitukāmo
upasankamituṃ	upasaṅkamituṃ
upasankamitvā	upasaṅkamitvā
upasankamma	upasaṅkamma
upasinghati	upasiṅghati
upasinghasi	upasiṅghasi
upasinghatu	upasiṅghatu
upekkhāsambojjhango	upekkhāsambojjhaṅgo
upekkhāsambojjhangaṃ	upekkhāsambojjhaṅgaṃ
upekkhāsambojjhangassa	upekkhāsambojjhaṅgassa
upekkhāsambojjhangaṭṭhāniyānaṃ	upekkhāsambojjhaṅgaṭṭhāniyānaṃ
upekkhāsambojjhangaṭṭhānīyā	upekkhāsambojjhaṅgaṭṭhānīyā
uposathangāni	uposathaṅgāni
ubhatosanghe	ubhatosaṅghe
ubhatosanghena	ubhatosaṅghena
ubhatosanghassa	ubhatosaṅghassa
ubhatovibhange	ubhatovibhaṅge
ummango	ummaṅgo
ummangaṃ	ummaṅgaṃ
ullanghanā	ullaṅghanā
ullangheti	ullaṅgheti
ullanghenti	ullaṅghenti
ussankitaparisankito	ussaṅkitaparisaṅkito
ussankitasutta	ussaṅkitasutta
ussankī	ussaṅkī
ussankiṃ	ussaṅkiṃ
ussankhapāda	ussaṅkhapāda
ussankhapādo	ussaṅkhapādo
ussoḷhipannarasangasamannāgato	ussoḷhipannarasaṅgasamannāgato
uḷunkaṃ	uḷuṅkaṃ
ūnakadvangulapabbe	ūnakadvaṅgulapabbe
ūnakadvangulapabbaparamaṃ	ūnakadvaṅgulapabbaparamaṃ
ekanga	ekaṅga
ekangaṃ	ekaṅgaṃ
ekangadassī	ekaṅgadassī
ekangadassino	ekaṅgadassino
ekangahīna	ekaṅgahīna
ekangahīnā	ekaṅgahīnā
ekapallankena	ekapallaṅkena
ekekalomūpacitangavā	ekekalomūpacitaṅgavā
eṇijangho	eṇijaṅgho
eṇijanghaṃ	eṇijaṅghaṃ
eṇijanghena	eṇijaṅghena
eṇijanghalakkhaṇaṃ	eṇijaṅghalakkhaṇaṃ
eṇijanghasutta	eṇijaṅghasutta
eṇeyyajangho	eṇeyyajaṅgho
etankāraṇā	etaṅkāraṇā
evankāmā	evaṅkāmā
evankāmānaṃ	evaṅkāmānaṃ
evankārī	evaṅkārī
evangatāni	evaṅgatāni
evangatikā	evaṅgatikā
evangahitā	evaṅgahitā
evangotta	evaṅgotta
evangotto	evaṅgotto
evangottā	evaṅgottā
evaṃsankhāro	evaṃsaṅkhāro
odātālankāra	odātālaṅkāra
odātālankārā	odātālaṅkārā
olanghanā	olaṅghanā
olangheti	olaṅgheti
olanghenti	olaṅghenti
ovādūpasankamanaṃ	ovādūpasaṅkamanaṃ
ovādūpasankamanasikkhāpada	ovādūpasaṅkamanasikkhāpada
kanka	kaṅka
kanko	kaṅko
kankā	kaṅkā
kankehi	kaṅkehi
kankassa	kaṅkassa
kankaṇaṃ	kaṅkaṇaṃ
kankhacchida	kaṅkhacchida
kankhachidaṃ	kaṅkhachidaṃ
kankhati	kaṅkhati
kankhanti	kaṅkhanti
kankhasi	kaṅkhasi
kankhāmi	kaṅkhāmi
kankha	kaṅkha
kankheyya	kaṅkheyya
kankhetha	kaṅkhetha
kankheyyaṃ	kaṅkheyyaṃ
kankhanīya	kaṅkhanīya
kankhanīye	kaṅkhanīye
kankhā	kaṅkhā
kankhaṃ	kaṅkhaṃ
kankhato	kaṅkhato
kankhāṭṭhāniyesu	kaṅkhāṭṭhāniyesu
kankhāṭhāniyesu	kaṅkhāṭhāniyesu
kankhāṭhānīyesu	kaṅkhāṭhānīyesu
kankhādhammo	kaṅkhādhammo
kankhādhammaṃ	kaṅkhādhammaṃ
kankhāyitaṃ	kaṅkhāyitaṃ
kankhārevata	kaṅkhārevata
kankhārevato	kaṅkhārevato
kankhārevataṃ	kaṅkhārevataṃ
kankhārevatattheragāthā	kaṅkhārevatattheragāthā
kankhārevatasutta	kaṅkhārevatasutta
kankhāvitaraṇavisuddhatthā	kaṅkhāvitaraṇavisuddhatthā
kankhāvitaraṇavisuddhatthaṃ	kaṅkhāvitaraṇavisuddhatthaṃ
kankhāvitaraṇavisuddhi	kaṅkhāvitaraṇavisuddhi
kankhāvitaraṇavisuddhiṃ	kaṅkhāvitaraṇavisuddhiṃ
kankhi	kaṅkhi
kankhī	kaṅkhī
kankhīnaṃ	kaṅkhīnaṃ
kankhita	kaṅkhita
kankhitā	kaṅkhitā
kankhitaṃ	kaṅkhitaṃ
kankhituṃ	kaṅkhituṃ
kankhivicikicchisandosahetu	kaṅkhivicikicchisandosahetu
kankheyyasutta	kaṅkheyyasutta
kangu	kaṅgu
kajangalāyaṃ	kajaṅgalāyaṃ
kaṭṭhakatangāre	kaṭṭhakataṅgāre
kaṇhasankhātā	kaṇhasaṅkhātā
katangasamannāgataṃ	kataṅgasamannāgataṃ
katangavippahīnaṃ	kataṅgavippahīnaṃ
katiangikaṃ	katiaṅgikaṃ
kathankathā	kathaṅkathā
kathankathāhi	kathaṅkathāhi
kathankathī	kathaṅkathī
kathankathiṃ	kathaṅkathiṃ
kathankaro	kathaṅkaro
kathangotto	kathaṅgotto
kathangottā	kathaṅgottā
kammakārakasanghaṃ	kammakārakasaṅghaṃ
kammakārakasanghe	kammakārakasaṅghe
kariyacariyasusangahaṃ	kariyacariyasusaṅgahaṃ
kalingaṃ	kaliṅgaṃ
kalingassa	kaliṅgassa
kalingānaṃ	kaliṅgānaṃ
kalingaro	kaliṅgaro
kalingaraṃ	kaliṅgaraṃ
kalingarasutta	kaliṅgarasutta
kalingarūpadhānā	kaliṅgarūpadhānā
kalyāṇasangatiko	kalyāṇasaṅgatiko
kalyāṇasampavanko	kalyāṇasampavaṅko
kalyāṇasampavankassa	kalyāṇasampavaṅkassa
kalyāṇasampavankatā	kalyāṇasampavaṅkatā
kalyāṇasampavankata	kalyāṇasampavaṅkata
kaḷingaraṃ	kaḷiṅgaraṃ
kāmankaro	kāmaṅkaro
kāmangamo	kāmaṅgamo
kāmasankappo	kāmasaṅkappo
kāmasankappaṃ	kāmasaṅkappaṃ
kāmasankappabahulo	kāmasaṅkappabahulo
kāyaduccaritasamangī	kāyaduccaritasamaṅgī
kāyasankhāro	kāyasaṅkhāro
kāyasankhārā	kāyasaṅkhārā
kāyasankhāraṃ	kāyasaṅkhāraṃ
kāyasankhāre	kāyasaṅkhāre
kāyasankhārānaṃ	kāyasaṅkhārānaṃ
kāyasucaritasamangī	kāyasucaritasamaṅgī
kāyavanko	kāyavaṅko
kāyavankaṃ	kāyavaṅkaṃ
kāyavankānaṃ	kāyavaṅkānaṃ
kārakasanghaṃ	kārakasaṅghaṃ
kālankata	kālaṅkata
kālankato	kālaṅkato
kālankatā	kālaṅkatā
kālankataṃ	kālaṅkataṃ
kālankatāni	kālaṅkatāni
kālankate	kālaṅkate
kālankatehi	kālaṅkatehi
kālankatāya	kālaṅkatāya
kālankatassa	kālaṅkatassa
kālankatānaṃ	kālaṅkatānaṃ
kālankatesu	kālaṅkatesu
kālankatapurisa	kālaṅkatapurisa
kālankareyya	kālaṅkareyya
kālankiriyā	kālaṅkiriyā
kālankiriyāya	kālaṅkiriyāya
kālankiriya	kālaṅkiriya
kālapabbangasankāso	kālapabbaṅgasaṅkāso
kālingassa	kāliṅgassa
kālingarañño	kāliṅgarañño
kālingāraññaṃ	kāliṅgāraññaṃ
kinkankhati	kiṅkaṅkhati
kinkaṇikasaddo	kiṅkaṇikasaddo
kinkato	kiṅkato
kinkaraṇīyāni	kiṅkaraṇīyāni
kinkaraṇīyesu	kiṅkaraṇīyesu
kinkārapaṭissāvī	kiṅkārapaṭissāvī
kinkārapaṭissāvinī	kiṅkārapaṭissāvinī
kinkārapaṭissāviniyo	kiṅkārapaṭissāviniyo
kinkiṇikajālehi	kiṅkiṇikajālehi
kinkiṇikajālānaṃ	kiṅkiṇikajālānaṃ
kinkiṇikā	kiṅkiṇikā
kinkusalagavesī	kiṅkusalagavesī
kinkusalānuesī	kiṅkusalānuesī
kingatikā	kiṅgatikā
kimangaṃ	kimaṅgaṃ
kukkurasanghaṃ	kukkurasaṅghaṃ
kukkurasanghaparivutā	kukkurasaṅghaparivutā
kulankapādakaṃ	kulaṅkapādakaṃ
kulangāro	kulaṅgāro
kusalasankappā	kusalasaṅkappā
kusalasankhātā	kusalasaṅkhātā
kūṭangamā	kūṭaṅgamā
kotūhalamangalāni	kotūhalamaṅgalāni
kotūhalamangalena	kotūhalamaṅgalena
kotūhalamangaliko	kotūhalamaṅgaliko
kolankolo	kolaṅkolo
kolankolassa	kolaṅkolassa
khaḷunko	khaḷuṅko
khaḷunkena	khaḷuṅkena
khaḷunkajhāyitaṃ	khaḷuṅkajhāyitaṃ
khemankaro	khemaṅkaro
khemankarassa	khemaṅkarassa
gangā	gaṅgā
gangaṃ	gaṅgaṃ
gangāya	gaṅgāya
ganga	gaṅga
gangātīre	gaṅgātīre
gangātīriyattheragāthā	gaṅgātīriyattheragāthā
gangānadiṃ	gaṅgānadiṃ
gangānadīādisutta	gaṅgānadīādisutta
gangānadīādisuttadvādasaka	gaṅgānadīādisuttadvādasaka
gangāpeyyālaṃ	gaṅgāpeyyālaṃ
gangāpeyyālavagga	gaṅgāpeyyālavagga
gangāpeyyālavaggo	gaṅgāpeyyālavaggo
gangāsamena	gaṅgāsamena
gangāsutta	gaṅgāsutta
gangāsoto	gaṅgāsoto
gangodakaṃ	gaṅgodakaṃ
gajangalaṃ	gajaṅgalaṃ
gajangalāyaṃ	gajaṅgalāyaṃ
gaṇasanghacārī	gaṇasaṅghacārī
gaṇācariyasāvakasangha	gaṇācariyasāvakasaṅgha
gaṇācariyasāvakasanghā	gaṇācariyasāvakasaṅghā
gamiyābhisankhāro	gamiyābhisaṅkhāro
gihilinge	gihiliṅge
gihilingena	gihiliṅgena
gotamasāvakasangho	gotamasāvakasaṅgho
gonangula	gonaṅgula
gopānasivanko	gopānasivaṅko
gopānasivankaṃ	gopānasivaṅkaṃ
gosingo	gosiṅgo
gosingasālavanaṃ	gosiṅgasālavanaṃ
gosingasālavanadāyo	gosiṅgasālavanadāyo
gosingasālavanadāye	gosiṅgasālavanadāye
cankamo	caṅkamo
cankamā	caṅkamā
cankamaṃ	caṅkamaṃ
cankame	caṅkame
cankamena	caṅkamena
cankamāya	caṅkamāya
cankamato	caṅkamato
cankamati	caṅkamati
cankamanti	caṅkamanti
cankamante	caṅkamante
cankamāmi	caṅkamāmi
cankamantaṃ	caṅkamantaṃ
cankameyya	caṅkameyya
cankameyyaṃ	caṅkameyyaṃ
cankamissanti	caṅkamissanti
cankamissāmi	caṅkamissāmi
cankamana	caṅkamana
cankamanasālā	caṅkamanasālā
cankamanasālāyo	caṅkamanasālāyo
cankamanasālaṃ	caṅkamanasālaṃ
cankamanasālāyaṃ	caṅkamanasālāyaṃ
cankamanto	caṅkamanto
cankamantā	caṅkamantā
cankamatī	caṅkamatī
cankamantī	caṅkamantī
cankamantassa	caṅkamantassa
cankamantānaṃ	caṅkamantānaṃ
cankamamāno	caṅkamamāno
cankamamāne	caṅkamamāne
cankamamānesu	caṅkamamānesu
cankamasutta	caṅkamasutta
cankamādhigato	caṅkamādhigato
cankami	caṅkami
cankamiṃ	caṅkamiṃ
cankamitvā	caṅkamitvā
cankī	caṅkī
cankiṃ	caṅkiṃ
cankissa	caṅkissa
cankīsutta	caṅkīsutta
cankīsuttaṃ	caṅkīsuttaṃ
cangavāro	caṅgavāro
cangavāraṃ	caṅgavāraṃ
catutthasanghādisesasikkhāpadaṃ	catutthasaṅghādisesasikkhāpadaṃ
caturanga	caturaṅga
caturangasamannāgataṃ	caturaṅgasamannāgataṃ
caturanginī	caturaṅginī
caturanginiṃ	caturaṅginiṃ
caturanginiyā	caturaṅginiyā
caturangula	caturaṅgula
caturangulaṃ	caturaṅgulaṃ
caturangule	caturaṅgule
caturangulikā	caturaṅgulikā
caturangulomako	caturaṅgulomako
caturāsītipallankasahassāni	caturāsītipallaṅkasahassāni
candanangalika	candanaṅgalika
candanangaliko	candanaṅgaliko
candanangalikā	candanaṅgalikā
candanangalikaṃ	candanaṅgalikaṃ
cingulakaṃ	ciṅgulakaṃ
cingulakena	ciṅgulakena
cingulāyitvā	ciṅgulāyitvā
cingulikaṃ	ciṅgulikaṃ
cittapārisuddhipadhāniyangaṃ	cittapārisuddhipadhāniyaṅgaṃ
cittapārisuddhipadhāniyangena	cittapārisuddhipadhāniyaṅgena
cittasankappo	cittasaṅkappo
cittasankilesā	cittasaṅkilesā
cittasankhāro	cittasaṅkhāro
cittasankhārā	cittasaṅkhārā
cittasankhāraṃ	cittasaṅkhāraṃ
cittasankhārānaṃ	cittasaṅkhārānaṃ
cittasankhārapaṭisaṃvedī	cittasaṅkhārapaṭisaṃvedī
cittasankhārappaṭisaṃvedī	cittasaṅkhārappaṭisaṃvedī
cittasamādhipadhānasankhārasamannāgataṃ	cittasamādhipadhānasaṅkhārasamannāgataṃ
cittasamādhippadhānasankhārasamannāgato	cittasamādhippadhānasaṅkhārasamannāgato
cittasamādhippadhānasankhārasamannāgataṃ	cittasamādhippadhānasaṅkhārasamannāgataṃ
cittālankāracittaparikkhāraṃ	cittālaṅkāracittaparikkhāraṃ
cittālankāracittaparikkhāratthaṃ	cittālaṅkāracittaparikkhāratthaṃ
cīvarasankamanīyaṃ	cīvarasaṅkamanīyaṃ
cīvarasankamanīyasikkhāpada	cīvarasaṅkamanīyasikkhāpada
cīvaravibhango	cīvaravibhaṅgo
cīvaravibhangaṃ	cīvaravibhaṅgaṃ
cūḷakammavibhangasutta	cūḷakammavibhaṅgasutta
cūḷakammavibhangasuttaṃ	cūḷakammavibhaṅgasuttaṃ
cūḷagosingasutta	cūḷagosiṅgasutta
cūḷagosingasuttaṃ	cūḷagosiṅgasuttaṃ
cūḷataṇhāsankhayasutta	cūḷataṇhāsaṅkhayasutta
cūḷataṇhāsankhayasuttaṃ	cūḷataṇhāsaṅkhayasuttaṃ
chaṭṭhasanghādisesasikkhāpadaṃ	chaṭṭhasaṅghādisesasikkhāpadaṃ
chadhātuvibhangaṃ	chadhātuvibhaṅgaṃ
chandasamādhipadhānasankhārasamannāgataṃ	chandasamādhipadhānasaṅkhārasamannāgataṃ
chandasamādhippadhānasankhārasamannāgato	chandasamādhippadhānasaṅkhārasamannāgato
chandasamādhippadhānasankhārasamannāgataṃ	chandasamādhippadhānasaṅkhārasamannāgataṃ
chaḷangadānasutta	chaḷaṅgadānasutta
chaḷangasamannāgato	chaḷaṅgasamannāgato
chaḷangasamannāgatā	chaḷaṅgasamannāgatā
chaḷangasamannāgataṃ	chaḷaṅgasamannāgataṃ
chaḷangasamannāgatāya	chaḷaṅgasamannāgatāya
jangalaṃ	jaṅgalaṃ
jangalānaṃ	jaṅgalānaṃ
jangha	jaṅgha
janghā	jaṅghā
janghāyo	jaṅghāyo
janghaṃ	jaṅghaṃ
janghāhi	jaṅghāhi
janghāsu	jaṅghāsu
janghaṭṭhikaṃ	jaṅghaṭṭhikaṃ
janghapesanikena	jaṅghapesanikena
janghavihāraṃ	jaṅghavihāraṃ
janghāvihāraṃ	jaṅghāvihāraṃ
jangheyyaka	jaṅgheyyaka
jangheyyakaṃ	jaṅgheyyakaṃ
jaṭāpanko	jaṭāpaṅko
jarasingālo	jarasiṅgālo
jarasingāle	jarasiṅgāle
jarasingālassa	jarasiṅgālassa
jātimaraṇasankhaye	jātimaraṇasaṅkhaye
jātivibhangaṃ	jātivibhaṅgaṃ
jīvitasankhayā	jīvitasaṅkhayā
jīvitasankhayamhi	jīvitasaṅkhayamhi
jīvitasankhāraṃ	jīvitasaṅkhāraṃ
jegucchasankhāto	jegucchasaṅkhāto
jegucchasankhātā	jegucchasaṅkhātā
ñātisangha	ñātisaṅgha
ñātisanghā	ñātisaṅghā
ñātisanghaṃ	ñātisaṅghaṃ
ṭankitamañce	ṭaṅkitamañce
tankhaṇikā	taṅkhaṇikā
tankhaṇikaṃ	taṅkhaṇikaṃ
tankhaṇikāya	taṅkhaṇikāya
tankhaṇikāyaṃ	taṅkhaṇikāyaṃ
tankhantikā	taṅkhantikā
taṇhāsankhayasutta	taṇhāsaṅkhayasutta
taṇhāsankhayavimutto	taṇhāsaṅkhayavimutto
taṇhāsankhayavimuttā	taṇhāsaṅkhayavimuttā
taṇhāsankhayavimuttassa	taṇhāsaṅkhayavimuttassa
taṇhāsankhayavimuttiṃ	taṇhāsaṅkhayavimuttiṃ
tatiyasanghādisesasikkhāpadaṃ	tatiyasaṅghādisesasikkhāpadaṃ
tatiyavibhangasutta	tatiyavibhaṅgasutta
tathāgatasāvakasangho	tathāgatasāvakasaṅgho
tadanga	tadaṅga
tadangena	tadaṅgena
tadanganibbānasutta	tadaṅganibbānasutta
tadanganibbuto	tadaṅganibbuto
tadatthangataṃ	tadatthaṅgataṃ
tamabhikankhati	tamabhikaṅkhati
tamabhikankhāmi	tamabhikaṅkhāmi
tiṇodakasankhaye	tiṇodakasaṅkhaye
tiporisangā	tiporisaṅgā
timingalo	timiṅgalo
timitimingalo	timitimiṅgalo
timirapingalo	timirapiṅgalo
tiriyangamāni	tiriyaṅgamāni
tilasanguḷikā	tilasaṅguḷikā
tilasanguḷika	tilasaṅguḷika
tunganāsikaṃ	tuṅganāsikaṃ
tenangena	tenaṅgena
tenupasankanto	tenupasaṅkanto
tenupasankamati	tenupasaṅkamati
tenupasankamanti	tenupasaṅkamanti
tenupasankamante	tenupasaṅkamante
tenupasankamatha	tenupasaṅkamatha
tenupasankamatu	tenupasaṅkamatu
tenupasankama	tenupasaṅkama
tenupasankameyya	tenupasaṅkameyya
tenupasankameyyuṃ	tenupasaṅkameyyuṃ
tenupasankameyyāma	tenupasaṅkameyyāma
tenupasankameyyaṃ	tenupasaṅkameyyaṃ
tenupasankamissāmi	tenupasaṅkamissāmi
tenupasankamissāma	tenupasaṅkamissāma
tenupasankamantī	tenupasaṅkamantī
tenupasankami	tenupasaṅkami
tenupasankamiṃsu	tenupasaṅkamiṃsu
tenupasankamiṃ	tenupasaṅkamiṃ
tenupasankamimha	tenupasaṅkamimha
tenupasankamimhā	tenupasaṅkamimhā
theyyasankhātaṃ	theyyasaṅkhātaṃ
dakkhiṇāvibhangasutta	dakkhiṇāvibhaṅgasutta
dakkhiṇāvibhangasuttaṃ	dakkhiṇāvibhaṅgasuttaṃ
dasangasamannāgato	dasaṅgasamannāgato
dasangasutta	dasaṅgasutta
dasamasanghādisesasikkhāpadaṃ	dasamasaṅghādisesasikkhāpadaṃ
dāruvankānaṃ	dāruvaṅkānaṃ
diṭṭhasutamutaviññātabbasankhāramattena	diṭṭhasutamutaviññātabbasaṅkhāramattena
diṭṭhipārisuddhipadhāniyangaṃ	diṭṭhipārisuddhipadhāniyaṅgaṃ
diṭṭhipārisuddhipadhāniyangena	diṭṭhipārisuddhipadhāniyaṅgena
dinnapāṭikankhī	dinnapāṭikaṅkhī
disangataṃ	disaṅgataṃ
disangamika	disaṅgamika
disangamiko	disaṅgamiko
disangamikā	disaṅgamikā
dīghanguli	dīghaṅguli
dīghangulī	dīghaṅgulī
duggandhasankhāto	duggandhasaṅkhāto
duggandhasankhātā	duggandhasaṅkhātā
dutiyagangāpeyyālavagga	dutiyagaṅgāpeyyālavagga
dutiyasangāmasutta	dutiyasaṅgāmasutta
dutiyasanghādisesasikkhāpadaṃ	dutiyasaṅghādisesasikkhāpadaṃ
dutiyasanghikacetāpanasikkhāpada	dutiyasaṅghikacetāpanasikkhāpada
dutiyasingālasutta	dutiyasiṅgālasutta
dutiyavibhangasutta	dutiyavibhaṅgasutta
dummanku	dummaṅku
dummankūnaṃ	dummaṅkūnaṃ
dummankuyaṃ	dummaṅkuyaṃ
durupasankamā	durupasaṅkamā
dūrangama	dūraṅgama
dūrangamo	dūraṅgamo
dūrangamā	dūraṅgamā
dūrangamaṃ	dūraṅgamaṃ
devāsurasangāmo	devāsurasaṅgāmo
devāsurasangāme	devāsurasaṅgāme
devāsurasangāmasutta	devāsurasaṅgāmasutta
dvangulā	dvaṅgulā
dvangulāya	dvaṅgulāya
dvangulakappo	dvaṅgulakappo
dvangulapaññāya	dvaṅgulapaññāya
dvangulapabbaparamaṃ	dvaṅgulapabbaparamaṃ
dhanka	dhaṅka
dhankaṃ	dhaṅkaṃ
dhankarūpā	dhaṅkarūpā
dhammasankappo	dhammasaṅkappo
dhammasankappaṃ	dhammasaṅkappaṃ
dhammasangaho	dhammasaṅgaho
dhammavicayasambojjhango	dhammavicayasambojjhaṅgo
dhammavicayasambojjhangaṃ	dhammavicayasambojjhaṅgaṃ
dhammavicayasambojjhangassa	dhammavicayasambojjhaṅgassa
dhātuvibhangassa	dhātuvibhaṅgassa
dhātuvibhangasutta	dhātuvibhaṅgasutta
dhātuvibhangasuttaṃ	dhātuvibhaṅgasuttaṃ
dhutanga	dhutaṅga
dhutangā	dhutaṅgā
dhutangava	dhutaṅgava
naalamariyasankhātā	naalamariyasaṅkhātā
nagarapaṭisankhārikāni	nagarapaṭisaṅkhārikāni
nangala	naṅgala
nangalaṃ	naṅgalaṃ
nangalā	naṅgalā
nangalena	naṅgalena
nangalehi	naṅgalehi
nangalakaṭṭhakaraṇaṃ	naṅgalakaṭṭhakaraṇaṃ
nangalamukhāni	naṅgalamukhāni
nangalasatāni	naṅgalasatāni
nangalāvattanī	naṅgalāvattanī
nangalīsā	naṅgalīsā
nangalīsa	naṅgalīsa
nanguṭṭhaṃ	naṅguṭṭhaṃ
nanguṭṭhe	naṅguṭṭhe
nanguṭṭhena	naṅguṭṭhena
nappaṭikankhati	nappaṭikaṅkhati
nappaṭikankhe	nappaṭikaṅkhe
naragaṇasanghasevitā	naragaṇasaṅghasevitā
navanga	navaṅga
navanguposathasutta	navaṅguposathasutta
navamasanghādisesasikkhāpadaṃ	navamasaṅghādisesasikkhāpadaṃ
nākankhati	nākaṅkhati
nākankhāmi	nākaṅkhāmi
nākankhissati	nākaṅkhissati
nābhisankharonti	nābhisaṅkharonti
nālankammaniyaṃ	nālaṅkammaniyaṃ
nāvakankhanti	nāvakaṅkhanti
nāvakankhāmi	nāvakaṅkhāmi
nāḷijangho	nāḷijaṅgho
nāḷijanghaṃ	nāḷijaṅghaṃ
nikkankho	nikkaṅkho
nikkankhā	nikkaṅkhā
nikkankhassa	nikkaṅkhassa
niṭṭhangato	niṭṭhaṅgato
niṭṭhangatasutta	niṭṭhaṅgatasutta
nibbānangamā	nibbānaṅgamā
niyatisangatibhāvapariṇatā	niyatisaṅgatibhāvapariṇatā
nirankato	niraṅkato
nirankatvā	niraṅkatvā
nisankhati	nisaṅkhati
nīlālankāra	nīlālaṅkāra
nīlālankārā	nīlālaṅkārā
nupasankheyyo	nupasaṅkheyyo
nekkhammasankappo	nekkhammasaṅkappo
nekkhammasankappaṃ	nekkhammasaṅkappaṃ
nekkhammasankappabahulo	nekkhammasaṅkappabahulo
nemangamā	nemaṅgamā
nelango	nelaṅgo
nelangaṃ	nelaṅgaṃ
pakkhasankanto	pakkhasaṅkanto
pakkhasankantā	pakkhasaṅkantā
pakkhasankantesu	pakkhasaṅkantesu
panka	paṅka
panko	paṅko
pankā	paṅkā
pankaṃ	paṅkaṃ
panke	paṅke
pankena	paṅkena
pankamhā	paṅkamhā
pankamhi	paṅkamhi
pankajātaṃ	paṅkajātaṃ
pango	paṅgo
pangacīraṃ	paṅgacīraṃ
pangacīrena	paṅgacīrena
paccekapallankesu	paccekapallaṅkesu
pañcakango	pañcakaṅgo
pañcakangaṃ	pañcakaṅgaṃ
pañcakangena	pañcakaṅgena
pañcakangassa	pañcakaṅgassa
pañcakangasutta	pañcakaṅgasutta
pañcangaṃ	pañcaṅgaṃ
pañcangāni	pañcaṅgāni
pañcangasamannāgato	pañcaṅgasamannāgato
pañcangasamannāgataṃ	pañcaṅgasamannāgataṃ
pañcangasamannāgate	pañcaṅgasamannāgate
pañcangasutta	pañcaṅgasutta
pañcangavippahīno	pañcaṅgavippahīno
pañcangavippahīnaṃ	pañcaṅgavippahīnaṃ
pañcangavippahīne	pañcaṅgavippahīne
pañcangiko	pañcaṅgiko
pañcangikā	pañcaṅgikā
pañcangikaṃ	pañcaṅgikaṃ
pañcangike	pañcaṅgike
pañcangikena	pañcaṅgikena
pañcangikassa	pañcaṅgikassa
pañcangikasutta	pañcaṅgikasutta
pañcangikavagga	pañcaṅgikavagga
pañcangikavaggo	pañcaṅgikavaggo
pañcangulikaṃ	pañcaṅgulikaṃ
pañcamasanghādisesasikkhāpadaṃ	pañcamasaṅghādisesasikkhāpadaṃ
pañcasangātigo	pañcasaṅgātigo
paṭange	paṭaṅge
paṭikankhati	paṭikaṅkhati
paṭikankhāmi	paṭikaṅkhāmi
paṭikankhāma	paṭikaṅkhāma
paṭikūlasankhāto	paṭikūlasaṅkhāto
paṭikūlasankhātā	paṭikūlasaṅkhātā
paṭisankhate	paṭisaṅkhate
paṭisankharaṇa	paṭisaṅkharaṇa
paṭisankharaṇaṃ	paṭisaṅkharaṇaṃ
paṭisankhariṃsu	paṭisaṅkhariṃsu
paṭisankharoti	paṭisaṅkharoti
paṭisankharonti	paṭisaṅkharonti
paṭisankharoma	paṭisaṅkharoma
paṭisankhareyyāma	paṭisaṅkhareyyāma
paṭisankharissati	paṭisaṅkharissati
paṭisankharonte	paṭisaṅkharonte
paṭisankhā	paṭisaṅkhā
paṭisankhāya	paṭisaṅkhāya
paṭisankha	paṭisaṅkha
paṭisankhānabalaṃ	paṭisaṅkhānabalaṃ
paṭisankhānabalā	paṭisaṅkhānabalā
paṭisankhānabalasutta	paṭisaṅkhānabalasutta
paṭisankhāraṃ	paṭisaṅkhāraṃ
paṭisankhārāpeti	paṭisaṅkhārāpeti
paṭihankhāmi	paṭihaṅkhāmi
paṭihankhāma	paṭihaṅkhāma
paṭhamasangāmasutta	paṭhamasaṅgāmasutta
paṭhamasanghādisesasikkhāpadaṃ	paṭhamasaṅghādisesasikkhāpadaṃ
paṭhamavibhangasutta	paṭhamavibhaṅgasutta
paṇītasankhātataraṃ	paṇītasaṅkhātataraṃ
paduṭṭhamanasankappo	paduṭṭhamanasaṅkappo
paduṭṭhamanasankappā	paduṭṭhamanasaṅkappā
paduṭṭhamanasankappaṃ	paduṭṭhamanasaṅkappaṃ
padhānasankhāra	padhānasaṅkhāra
padhānasankhārā	padhānasaṅkhārā
padhāniyangāni	padhāniyaṅgāni
padhāniyangehi	padhāniyaṅgehi
padhāniyangāna	padhāniyaṅgāna
padhāniyangasutta	padhāniyaṅgasutta
papañcasankhā	papañcasaṅkhā
papañcasankhāya	papañcasaṅkhāya
papañcasaññāsankhā	papañcasaññāsaṅkhā
papañcasaññāsankhāya	papañcasaññāsaṅkhāya
papañcasaññāsankhājātiko	papañcasaññāsaṅkhājātiko
papañcasaññāsankhānidāno	papañcasaññāsaṅkhānidāno
papañcasaññāsankhānirodhasāruppagāminiṃ	papañcasaññāsaṅkhānirodhasāruppagāminiṃ
papañcasaññāsankhāpabhavo	papañcasaññāsaṅkhāpabhavo
papañcasaññāsankhāsamudayo	papañcasaññāsaṅkhāsamudayo
papañcasaññāsankhāsamudācaraṇapaññattiṃ	papañcasaññāsaṅkhāsamudācaraṇapaññattiṃ
pabbatasankhepe	pabbatasaṅkhepe
pabhankara	pabhaṅkara
pabhankaro	pabhaṅkaro
pabhankarā	pabhaṅkarā
pabhangu	pabhaṅgu
pabhangū	pabhaṅgū
pabhanguṃ	pabhaṅguṃ
pabhangunā	pabhaṅgunā
pabhangunaṃ	pabhaṅgunaṃ
pabhanguraṃ	pabhaṅguraṃ
pabhangusutta	pabhaṅgusutta
parankato	paraṅkato
parankatā	paraṅkatā
parankataṃ	paraṅkataṃ
paripuṇṇasankappa	paripuṇṇasaṅkappa
paripuṇṇasankappo	paripuṇṇasaṅkappo
paripuṇṇasankappā	paripuṇṇasaṅkappā
pariyositasankappo	pariyositasaṅkappo
pariyositasankappaṃ	pariyositasaṅkappaṃ
parisankasi	parisaṅkasi
parisanka	parisaṅka
parisankāya	parisaṅkāya
parisankito	parisaṅkito
parisankitaṃ	parisaṅkitaṃ
parisankite	parisaṅkite
parisankitassa	parisaṅkitassa
pallanka	pallaṅka
pallanko	pallaṅko
pallankā	pallaṅkā
pallankaṃ	pallaṅkaṃ
pallanke	pallaṅke
pallankena	pallaṅkena
pallankassa	pallaṅkassa
pallankasmiṃ	pallaṅkasmiṃ
pallankasahassāni	pallaṅkasahassāni
pallankasahassānaṃ	pallaṅkasahassānaṃ
passaddhakāyasankhāro	passaddhakāyasaṅkhāro
passaddhisambojjhango	passaddhisambojjhaṅgo
passaddhisambojjhangaṃ	passaddhisambojjhaṅgaṃ
passaddhisambojjhangassa	passaddhisambojjhaṅgassa
paṃsukūlikangaṃ	paṃsukūlikaṅgaṃ
pāṭankī	pāṭaṅkī
pāṭankiṃ	pāṭaṅkiṃ
pāṭikankha	pāṭikaṅkha
pāṭikankho	pāṭikaṅkho
pāṭikankhā	pāṭikaṅkhā
pāṭikankhaṃ	pāṭikaṅkhaṃ
pāṭikankhitabbā	pāṭikaṅkhitabbā
pāṭikankhitabbāni	pāṭikaṅkhitabbāni
pāṭikankhitabbāna	pāṭikaṅkhitabbāna
pāṭikankhino	pāṭikaṅkhino
pādanguṭṭhena	pādaṅguṭṭhena
pādanguṭṭhakena	pādaṅguṭṭhakena
pādūpasangayha	pādūpasaṅgayha
pāpasankappo	pāpasaṅkappo
pāpasankappaṃ	pāpasaṅkappaṃ
pāpasangatikā	pāpasaṅgatikā
pāpasampavanko	pāpasampavaṅko
pāpasampavankā	pāpasampavaṅkā
pāpasampavankassa	pāpasampavaṅkassa
pāmangaṃ	pāmaṅgaṃ
pāragangāya	pāragaṅgāya
pārangato	pāraṅgato
pārangatā	pāraṅgatā
pārangataṃ	pāraṅgataṃ
pārangatassa	pāraṅgatassa
pārangama	pāraṅgama
pārangamā	pāraṅgamā
pārangamasutta	pāraṅgamasutta
pārangāmī	pāraṅgāmī
pārisuddhipadhāniyangaṃ	pārisuddhipadhāniyaṅgaṃ
pārisuddhipadhāniyangāni	pārisuddhipadhāniyaṅgāni
pingalā	piṅgalā
pingalakoccho	piṅgalakoccho
pingiya	piṅgiya
pingiyo	piṅgiyo
pingiyā	piṅgiyā
pingiyāna	piṅgiyāna
pingiyamāṇavapucchā	piṅgiyamāṇavapucchā
pingiyāni	piṅgiyāni
pingiyānī	piṅgiyānī
pingiyāniṃ	piṅgiyāniṃ
pingiyāninā	piṅgiyāninā
pingiyānīsutta	piṅgiyānīsutta
piṭṭhasanghāṭaṃ	piṭṭhasaṅghāṭaṃ
piṭṭhasanghāṭassa	piṭṭhasaṅghāṭassa
piṇḍapātikangaṃ	piṇḍapātikaṅgaṃ
pituanke	pituaṅke
piyankara	piyaṅkara
piyankaramātā	piyaṅkaramātā
piyankarasutta	piyaṅkarasutta
pītālankārā	pītālaṅkārā
pītisambojjhango	pītisambojjhaṅgo
pītisambojjhangaṃ	pītisambojjhaṅgaṃ
pītisambojjhangassa	pītisambojjhaṅgassa
pītisambojjhangaṭṭhānīyā	pītisambojjhaṅgaṭṭhānīyā
pungavo	puṅgavo
pungavaṃ	puṅgavaṃ
puññābhisankhāro	puññābhisaṅkhāro
puññābhisankhāraṃ	puññābhisaṅkhāraṃ
punagangānadīādisutta	punagaṅgānadīādisutta
punagangāpeyyālavagga	punagaṅgāpeyyālavagga
pubbangama	pubbaṅgama
pubbangamo	pubbaṅgamo
pubbangamā	pubbaṅgamā
pubbangamaṃ	pubbaṅgamaṃ
pubbangamasutta	pubbaṅgamasutta
purisakhaḷunka	purisakhaḷuṅka
purisakhaḷunko	purisakhaḷuṅko
purisakhaḷunkā	purisakhaḷuṅkā
purisakhaḷunke	purisakhaḷuṅke
purisakhaḷunkajhāyitaṃ	purisakhaḷuṅkajhāyitaṃ
purisalingaṃ	purisaliṅgaṃ
pokkharasātibuddhūpasankamana	pokkharasātibuddhūpasaṅkamana
ponkhānuponkhaṃ	poṅkhānupoṅkhaṃ
bahisunkaghātaṃ	bahisuṅkaghātaṃ
bahujanapubbangamo	bahujanapubbaṅgamo
bahusankappaṃ	bahusaṅkappaṃ
bālasangatacārī	bālasaṅgatacārī
bāhirangasutta	bāhiraṅgasutta
bilangaṃ	bilaṅgaṃ
bilangathālikaṃ	bilaṅgathālikaṃ
bilangathālika	bilaṅgathālika
bilangadutiyaṃ	bilaṅgadutiyaṃ
bilangadutiyena	bilaṅgadutiyena
bilangikaṃ	bilaṅgikaṃ
bilangikassa	bilaṅgikassa
bilangikabhāradvājo	bilaṅgikabhāradvājo
bilangikasutta	bilaṅgikasutta
biḷangadutiyaṃ	biḷaṅgadutiyaṃ
bījanangalaṃ	bījanaṅgalaṃ
bojjhanga	bojjhaṅga
bojjhango	bojjhaṅgo
bojjhangā	bojjhaṅgā
bojjhangaṃ	bojjhaṅgaṃ
bojjhange	bojjhaṅge
bojjhangena	bojjhaṅgena
bojjhangehi	bojjhaṅgehi
bojjhangānaṃ	bojjhaṅgānaṃ
bojjhangesu	bojjhaṅgesu
bojjhangadesanāsutta	bojjhaṅgadesanāsutta
bojjhangapabba	bojjhaṅgapabba
bojjhangapabbaṃ	bojjhaṅgapabbaṃ
bojjhangaratanānaṃ	bojjhaṅgaratanānaṃ
bojjhangasaṃyuttaṃ	bojjhaṅgasaṃyuttaṃ
bojjhangasaṃyuttassa	bojjhaṅgasaṃyuttassa
bojjhangasutta	bojjhaṅgasutta
bojjhangavasena	bojjhaṅgavasena
byāpannacittapaduṭṭhamanasankappasandosahetu	byāpannacittapaduṭṭhamanasaṅkappasandosahetu
byāpādasankappo	byāpādasaṅkappo
byābhangihattho	byābhaṅgihattho
byābhangihatthā	byābhaṅgihatthā
byābhangiṃ	byābhaṅgiṃ
byābhangiyā	byābhaṅgiyā
byābhangīhi	byābhaṅgīhi
brahmaññasankhātā	brahmaññasaṅkhātā
bhango	bhaṅgo
bhangaṃ	bhaṅgaṃ
bhangāni	bhaṅgāni
bhayapaṭikankhī	bhayapaṭikaṅkhī
bhavanettisankhayā	bhavanettisaṅkhayā
bhavasankhāro	bhavasaṅkhāro
bhavasankhāraṃ	bhavasaṅkhāraṃ
bhikkhunisangha	bhikkhunisaṅgha
bhikkhunisangho	bhikkhunisaṅgho
bhikkhunisanghaṃ	bhikkhunisaṅghaṃ
bhikkhunisanghe	bhikkhunisaṅghe
bhikkhunisanghena	bhikkhunisaṅghena
bhikkhunisanghassa	bhikkhunisaṅghassa
bhikkhunivibhanga	bhikkhunivibhaṅga
bhikkhunivibhango	bhikkhunivibhaṅgo
bhikkhunivibhange	bhikkhunivibhaṅge
bhikkhusangha	bhikkhusaṅgha
bhikkhusangho	bhikkhusaṅgho
bhikkhusanghā	bhikkhusaṅghā
bhikkhusanghaṃ	bhikkhusaṅghaṃ
bhikkhusanghe	bhikkhusaṅghe
bhikkhusanghena	bhikkhusaṅghena
bhikkhusanghassa	bhikkhusaṅghassa
bhikkhusanghato	bhikkhusaṅghato
bhikkhusanghaparivuto	bhikkhusaṅghaparivuto
bhikkhusanghapurakkhato	bhikkhusaṅghapurakkhato
bhikkhusanghapurakkhataṃ	bhikkhusaṅghapurakkhataṃ
bhikkhuvibhanga	bhikkhuvibhaṅga
bhikkhuvibhange	bhikkhuvibhaṅge
bhinko	bhiṅko
bhinkacchāpā	bhiṅkacchāpā
bhinkāraṃ	bhiṅkāraṃ
bhingāraṃ	bhiṅgāraṃ
bhujangamaṃ	bhujaṅgamaṃ
bhūrisankhayo	bhūrisaṅkhayo
bheripaṇavasankhatiṇavaninnādasaddaṃ	bheripaṇavasaṅkhatiṇavaninnādasaddaṃ
bheripaṇavasankhatiṇavaninnādasaddena	bheripaṇavasaṅkhatiṇavaninnādasaddena
bheripaṇavasankhatiṇavaninnādasaddānaṃ	bheripaṇavasaṅkhatiṇavaninnādasaddānaṃ
bheripaṇavavaṃsasankhaḍiṇḍimaninnādasaddānaṃ	bheripaṇavavaṃsasaṅkhaḍiṇḍimaninnādasaddānaṃ
maggango	maggaṅgo
maggangā	maggaṅgā
maggangaṃ	maggaṅgaṃ
maggangasutta	maggaṅgasutta
maggaṭṭhangikayānayāyinī	maggaṭṭhaṅgikayānayāyinī
manku	maṅku
mankū	maṅkū
mankuṃ	maṅkuṃ
mankukattukāmo	maṅkukattukāmo
mankubhāvo	maṅkubhāvo
mankubhūto	maṅkubhūto
mankubhūtā	maṅkubhūtā
mankubhūtaṃ	maṅkubhūtaṃ
mankubhūte	maṅkubhūte
mankubhūtassa	maṅkubhūtassa
mangala	maṅgala
mangalo	maṅgalo
mangalā	maṅgalā
mangalaṃ	maṅgalaṃ
mangalāni	maṅgalāni
mangalasutta	maṅgalasutta
mangalasuttaṃ	maṅgalasuttaṃ
mangalavagga	maṅgalavagga
mangalavaggo	maṅgalavaggo
mangalikā	maṅgalikā
manguracchavi	maṅguracchavi
manguracchavī	maṅguracchavī
manguliṃ	maṅguliṃ
mangulitthisutta	maṅgulitthisutta
mangulitthī	maṅgulitthī
mangulitthi	maṅgulitthi
majjhegangāya	majjhegaṅgāya
majjhesinghāṭake	majjhesiṅghāṭake
matthalungaṃ	matthaluṅgaṃ
matthalungassa	matthaluṅgassa
manasankappo	manasaṅkappo
manoduccaritasamangī	manoduccaritasamaṅgī
manopubbangamā	manopubbaṅgamā
manosankhārā	manosaṅkhārā
manosankhāraṃ	manosaṅkhāraṃ
manosucaritasamangī	manosucaritasamaṅgī
manovanko	manovaṅko
manovankaṃ	manovaṅkaṃ
manovankānaṃ	manovaṅkānaṃ
mamankārā	mamaṅkārā
mahattamabhikankhatā	mahattamabhikaṅkhatā
mahākammavibhangaṃ	mahākammavibhaṅgaṃ
mahākammavibhange	mahākammavibhaṅge
mahākammavibhangasutta	mahākammavibhaṅgasutta
mahākammavibhangasuttaṃ	mahākammavibhaṅgasuttaṃ
mahāgosingasutta	mahāgosiṅgasutta
mahāgosingasuttaṃ	mahāgosiṅgasuttaṃ
mahājanasangahaṃ	mahājanasaṅgahaṃ
mahājanasangahanaṃ	mahājanasaṅgahanaṃ
mahātaṇhājālataṇhāsanghāṭappaṭimukkaṃ	mahātaṇhājālataṇhāsaṅghāṭappaṭimukkaṃ
mahātaṇhāsankhayasutta	mahātaṇhāsaṅkhayasutta
mahātaṇhāsankhayasuttaṃ	mahātaṇhāsaṅkhayasuttaṃ
mahānangalena	mahānaṅgalena
mahābhikkhusangho	mahābhikkhusaṅgho
mahāmigasangho	mahāmigasaṅgho
mahāsakuṇasangho	mahāsakuṇasaṅgho
mahāvibhanga	mahāvibhaṅga
mahāvibhango	mahāvibhaṅgo
mahāvibhange	mahāvibhaṅge
mātanga	mātaṅga
mātango	mātaṅgo
mātangaputtattheragāthā	mātaṅgaputtattheragāthā
mātangarañña	mātaṅgarañña
mātangaraññe	mātaṅgaraññe
mātangāraññaṃ	mātaṅgāraññaṃ
migasangha	migasaṅgha
migasanghe	migasaṅghe
migasanghassa	migasaṅghassa
micchāsankappa	micchāsaṅkappa
micchāsankappo	micchāsaṅkappo
micchāsankappā	micchāsaṅkappā
micchāsankappaṃ	micchāsaṅkappaṃ
micchāsankappe	micchāsaṅkappe
micchāsankappena	micchāsaṅkappena
micchāsankappassa	micchāsaṅkappassa
mihitapubbangamā	mihitapubbaṅgamā
mudingo	mudiṅgo
mudingaṃ	mudiṅgaṃ
mudingehi	mudiṅgehi
mudingassa	mudiṅgassa
mudingasadda	mudiṅgasadda
mudingasaddo	mudiṅgasaddo
mudingasaddaṃ	mudiṅgasaddaṃ
mudingasaddena	mudiṅgasaddena
mudutalunanguli	mudutalunaṅguli
mudutalunanguliyaṃ	mudutalunaṅguliyaṃ
yankhantiko	yaṅkhantiko
yangatikā	yaṅgatikā
yangatikāni	yaṅgatikāni
yadākankhasi	yadākaṅkhasi
yadākankha	yadākaṅkha
yuganangalaṃ	yuganaṅgalaṃ
yenakāmangamo	yenakāmaṅgamo
ranga	raṅga
rangena	raṅgena
rangakkhamo	raṅgakkhamo
rangakkhamaṃ	raṅgakkhamaṃ
rangajātaṃ	raṅgajātaṃ
rangajāte	raṅgajāte
rangamajjhe	raṅgamajjhe
rangaratta	raṅgaratta
rangarattā	raṅgarattā
rangarattāni	raṅgarattāni
ratikhiḍḍāsamangī	ratikhiḍḍāsamaṅgī
rājangaṃ	rājaṅgaṃ
rājangāni	rājaṅgāni
rūpasankappo	rūpasaṅkappo
rūpasankappaṃ	rūpasaṅkappaṃ
rūpasankhayavimutto	rūpasaṅkhayavimutto
rūpasankhāyavimutto	rūpasaṅkhāyavimutto
rūpasangaho	rūpasaṅgaho
rogātanko	rogātaṅko
rogātankaṃ	rogātaṅkaṃ
rogātankena	rogātaṅkena
langī	laṅgī
langiṃ	laṅgiṃ
langi	laṅgi
langhaka	laṅghaka
langhakā	laṅghakā
langhakānaṃ	laṅghakānaṃ
langhakāna	laṅghakāna
langhati	laṅghati
langhetu	laṅghetu
langhetuṃ	laṅghetuṃ
linga	liṅga
lingaṃ	liṅgaṃ
lingā	liṅgā
lingāni	liṅgāni
linge	liṅge
lingena	liṅgena
lingehi	liṅgehi
lingassa	liṅgassa
lingato	liṅgato
lingesu	liṅgesu
lingaleso	liṅgaleso
lingiya	liṅgiya
lomasakangiya	lomasakaṅgiya
lomasakangiyo	lomasakaṅgiyo
lomasakangiyā	lomasakaṅgiyā
lomasakangiyaṃ	lomasakaṅgiyaṃ
lomasakangiyattheragāthā	lomasakaṅgiyattheragāthā
lomasakangiyabhaddekarattasutta	lomasakaṅgiyabhaddekarattasutta
lomasakangiyabhaddekarattasuttaṃ	lomasakaṅgiyabhaddekarattasuttaṃ
lohitakālankārā	lohitakālaṅkārā
lohitanko	lohitaṅko
lohitankamayo	lohitaṅkamayo
lohitankamayā	lohitaṅkamayā
lohitankamayāni	lohitaṅkamayāni
lohitankamayassa	lohitaṅkamayassa
lohitango	lohitaṅgo
lohitālankārā	lohitālaṅkārā
sakuṇasangho	sakuṇasaṅgho
sakuṇasanghassa	sakuṇasaṅghassa
sakkūpasankama	sakkūpasaṅkama
sanka	saṅka
sanke	saṅke
sankāya	saṅkāya
sankaccika	saṅkaccika
sankaccikaṃ	saṅkaccikaṃ
sankaccikā	saṅkaccikā
sankaḍḍhanti	saṅkaḍḍhanti
sankaḍḍhanto	saṅkaḍḍhanto
sankaḍḍhitvā	saṅkaḍḍhitvā
sankati	saṅkati
sankanto	saṅkanto
sankantā	saṅkantā
sankantati	saṅkantati
sankanteyya	saṅkanteyya
sankantitvā	saṅkantitvā
sankappa	saṅkappa
sankappo	saṅkappo
sankappā	saṅkappā
sankappaṃ	saṅkappaṃ
sankappehi	saṅkappehi
sankappassa	saṅkappassa
sankappānaṃ	saṅkappānaṃ
sankappati	saṅkappati
sankappissati	saṅkappissati
sankappanānattaṃ	saṅkappanānattaṃ
sankappamaññāya	saṅkappamaññāya
sankapparāgo	saṅkapparāgo
sankappavitakkā	saṅkappavitakkā
sankappeti	saṅkappeti
sankappemi	saṅkappemi
sankappetuṃ	saṅkappetuṃ
sankama	saṅkama
sankamo	saṅkamo
sankamaṃ	saṅkamaṃ
sankamati	saṅkamati
sankamanti	saṅkamanti
sankameyya	saṅkameyya
sankamanāni	saṅkamanāni
sankami	saṅkami
sankampati	saṅkampati
sankampeyya	saṅkampeyya
sankampi	saṅkampi
sankampito	saṅkampito
sankampeti	saṅkampeti
sankampesi	saṅkampesi
sankampessati	saṅkampessati
sankaritvā	saṅkaritvā
sankasāyati	saṅkasāyati
sankasāyanti	saṅkasāyanti
sankasāyasi	saṅkasāyasi
sankasāyissanti	saṅkasāyissanti
sankassaṃ	saṅkassaṃ
sankassā	saṅkassā
sankassaraṃ	saṅkassaraṃ
sankassarasamācāro	saṅkassarasamācāro
sankassarasamācāraṃ	saṅkassarasamācāraṃ
sankassarācāro	saṅkassarācāro
sankavā	saṅkavā
sankavāya	saṅkavāya
sankavāyaṃ	saṅkavāyaṃ
sankavāsutta	saṅkavāsutta
sankāmeti	saṅkāmeti
sankāmessāmi	saṅkāmessāmi
sankāmetvā	saṅkāmetvā
sankāra	saṅkāra
sankāraṃ	saṅkāraṃ
sankārakūṭa	saṅkārakūṭa
sankārakūṭā	saṅkārakūṭā
sankārakūṭe	saṅkārakūṭe
sankārakūṭesu	saṅkārakūṭesu
sankāraggito	saṅkāraggito
sankārabhūtesu	saṅkārabhūtesu
sankāsaṃ	saṅkāsaṃ
sankāsanasutta	saṅkāsanasutta
sankāsanā	saṅkāsanā
sanki	saṅki
sankī	saṅkī
sankicca	saṅkicca
sankicco	saṅkicco
sankiccaṃ	saṅkiccaṃ
sankiṇṇaparikho	saṅkiṇṇaparikho
sankito	saṅkito
sankittīsu	saṅkittīsu
sankiyo	saṅkiyo
sankiyati	saṅkiyati
sankiyanti	saṅkiyanti
sankiyissati	saṅkiyissati
sankiyissanti	saṅkiyissanti
sankiraṇaṃ	saṅkiraṇaṃ
sankiliṭṭha	saṅkiliṭṭha
sankiliṭṭho	saṅkiliṭṭho
sankiliṭṭhā	saṅkiliṭṭhā
sankiliṭṭhaṃ	saṅkiliṭṭhaṃ
sankiliṭṭhe	saṅkiliṭṭhe
sankiliṭṭhena	saṅkiliṭṭhena
sankiliṭṭhacitto	saṅkiliṭṭhacitto
sankiliṭṭhacittā	saṅkiliṭṭhacittā
sankiliṭṭhatarā	saṅkiliṭṭhatarā
sankiliṭṭhābhā	saṅkiliṭṭhābhā
sankiliṭṭhābhānaṃ	saṅkiliṭṭhābhānaṃ
sankiliṭṭhābha	saṅkiliṭṭhābha
sankilissati	saṅkilissati
sankilissanti	saṅkilissanti
sankilissa	saṅkilissa
sankilesaṃ	saṅkilesaṃ
sankilesāya	saṅkilesāya
sankilesadhammo	saṅkilesadhammo
sankilesadhammā	saṅkilesadhammā
sankilesadhammaṃ	saṅkilesadhammaṃ
sankilesadhamme	saṅkilesadhamme
sankilesikā	saṅkilesikā
sankilesikaṃ	saṅkilesikaṃ
sankilesikāni	saṅkilesikāni
sankilesike	saṅkilesike
sankilesikehi	saṅkilesikehi
sankilesikadhammaṃ	saṅkilesikadhammaṃ
sankīyati	saṅkīyati
sankīyanti	saṅkīyanti
sankīyissati	saṅkīyissati
sankīyissanti	saṅkīyissanti
sankīḷantā	saṅkīḷantā
sankīḷante	saṅkīḷante
sanku	saṅku
sankunā	saṅkunā
sankuddho	saṅkuddho
sankupitaṃ	saṅkupitaṃ
sankulikā	saṅkulikā
sankulika	saṅkulika
sankusatena	saṅkusatena
sankusamāhato	saṅkusamāhato
sanketa	saṅketa
sanketaṃ	saṅketaṃ
sanketena	saṅketena
sanketakammaṃ	saṅketakammaṃ
sankha	saṅkha
sankho	saṅkho
sankhā	saṅkhā
sankhaṃ	saṅkhaṃ
sankhe	saṅkhe
sankhāya	saṅkhāya
sankhānaṃ	saṅkhānaṃ
sankhato	saṅkhato
sankhāna	saṅkhāna
sankhatā	saṅkhatā
sankhataṃ	saṅkhataṃ
sankhate	saṅkhate
sankhatassa	saṅkhatassa
sankhatamabhisankharonti	saṅkhatamabhisaṅkharonti
sankhatalakkhaṇāni	saṅkhatalakkhaṇāni
sankhatalakkhaṇāna	saṅkhatalakkhaṇāna
sankhatalakkhaṇasutta	saṅkhatalakkhaṇasutta
sankhatādhātu	saṅkhatādhātu
sankhatārammaṇā	saṅkhatārammaṇā
sankhatiyo	saṅkhatiyo
sankhadhamo	saṅkhadhamo
sankhadhamaṃ	saṅkhadhamaṃ
sankhadhamassa	saṅkhadhamassa
sankhadhamaupamā	saṅkhadhamaupamā
sankhadhamasutta	saṅkhadhamasutta
sankhapaṇavadindimasadda	saṅkhapaṇavadindimasadda
sankhapaṇavadindimasaddo	saṅkhapaṇavadindimasaddo
sankhapaṇavadindimasaddaṃ	saṅkhapaṇavadindimasaddaṃ
sankhamuṇḍika	saṅkhamuṇḍika
sankhamuṇḍikaṃ	saṅkhamuṇḍikaṃ
sankhayo	saṅkhayo
sankhayā	saṅkhayā
sankhayaṃ	saṅkhayaṃ
sankhaye	saṅkhaye
sankharājauppatti	saṅkharājauppatti
sankhalikabandhanena	saṅkhalikabandhanena
sankhalikāhi	saṅkhalikāhi
sankhalikhitaṃ	saṅkhalikhitaṃ
sankhasaddo	saṅkhasaddo
sankhasaddaṃ	saṅkhasaddaṃ
sankhasaddena	saṅkhasaddena
sankhasaddassa	saṅkhasaddassa
sankhasevālapaṇakaṃ	saṅkhasevālapaṇakaṃ
sankhavaṇṇapaṭibhāgāni	saṅkhavaṇṇapaṭibhāgāni
sankhavaṇṇappaṭibhāgāni	saṅkhavaṇṇappaṭibhāgāni
sankhāto	saṅkhāto
sankhātā	saṅkhātā
sankhātaṃ	saṅkhātaṃ
sankhātadhammo	saṅkhātadhammo
sankhātadhammāse	saṅkhātadhammāse
sankhātadhammassa	saṅkhātadhammassa
sankhātadhammānaṃ	saṅkhātadhammānaṃ
sankhātuṃ	saṅkhātuṃ
sankhāditvā	saṅkhāditvā
sankhāne	saṅkhāne
sankhānena	saṅkhānena
sankhāyako	saṅkhāyako
sankhāra	saṅkhāra
sankhāro	saṅkhāro
sankhārā	saṅkhārā
sankhāraṃ	saṅkhāraṃ
sankhāre	saṅkhāre
sankhārena	saṅkhārena
sankhārehi	saṅkhārehi
sankhārānaṃ	saṅkhārānaṃ
sankhārāna	saṅkhārāna
sankhāresu	saṅkhāresu
sankhāraaññāṇasutta	saṅkhāraaññāṇasutta
sankhārakkhandho	saṅkhārakkhandho
sankhārakkhandhe	saṅkhārakkhandhe
sankhārakkhandhassa	saṅkhārakkhandhassa
sankhāragataṃ	saṅkhāragataṃ
sankhāragate	saṅkhāragate
sankhārajātikaṃ	saṅkhārajātikaṃ
sankhāraṭṭhitikā	saṅkhāraṭṭhitikā
sankhārattāya	saṅkhārattāya
sankhārattāyaṃ	saṅkhārattāyaṃ
sankhāradukkhatā	saṅkhāradukkhatā
sankhāradhātu	saṅkhāradhātu
sankhāradhātuyā	saṅkhāradhātuyā
sankhāradhāturāgavinibandhaṃ	saṅkhāradhāturāgavinibandhaṃ
sankhāranidānaṃ	saṅkhāranidānaṃ
sankhāranirodha	saṅkhāranirodha
sankhāranirodho	saṅkhāranirodho
sankhāranirodhā	saṅkhāranirodhā
sankhāranirodhaṃ	saṅkhāranirodhaṃ
sankhāranirodhe	saṅkhāranirodhe
sankhāranirodhāya	saṅkhāranirodhāya
sankhāranirodhagāminī	saṅkhāranirodhagāminī
sankhāranirodhagāminiṃ	saṅkhāranirodhagāminiṃ
sankhāranirodhagāminiyā	saṅkhāranirodhagāminiyā
sankhāranirodhasāruppagāminī	saṅkhāranirodhasāruppagāminī
sankhārapaccayā	saṅkhārapaccayā
sankhārapabhavaṃ	saṅkhārapabhavaṃ
sankhārappatiṭṭhaṃ	saṅkhārappatiṭṭhaṃ
sankhārappadhānā	saṅkhārappadhānā
sankhārasankhayavimutto	saṅkhārasaṅkhayavimutto
sankhārasankhāyavimutto	saṅkhārasaṅkhāyavimutto
sankhārasamāpattipattabbaṃ	saṅkhārasamāpattipattabbaṃ
sankhārasamudayo	saṅkhārasamudayo
sankhārasamudayā	saṅkhārasamudayā
sankhārasamudayaṃ	saṅkhārasamudayaṃ
sankhārasamudaye	saṅkhārasamudaye
sankhārasutta	saṅkhārasutta
sankhārasokhummaṃ	saṅkhārasokhummaṃ
sankhārasokhummena	saṅkhārasokhummena
sankhāravantaṃ	saṅkhāravantaṃ
sankhāravipariṇāmaññathābhāvā	saṅkhāravipariṇāmaññathābhāvā
sankhāravipariṇāmānuparivattijā	saṅkhāravipariṇāmānuparivattijā
sankhāravipariṇāmānuparivatti	saṅkhāravipariṇāmānuparivatti
sankhārāniccataṃ	saṅkhārāniccataṃ
sankhārārammaṇaṃ	saṅkhārārammaṇaṃ
sankhārārāmassa	saṅkhārārāmassa
sankhārāvasesasamāpatti	saṅkhārāvasesasamāpatti
sankhārāvasesasamāpattipattabbaṃ	saṅkhārāvasesasamāpattipattabbaṃ
sankhārupapattiṃ	saṅkhārupapattiṃ
sankhārupapattisutta	saṅkhārupapattisutta
sankhārupapattisuttaṃ	saṅkhārupapattisuttaṃ
sankhārupayaṃ	saṅkhārupayaṃ
sankhārupādānakkhandho	saṅkhārupādānakkhandho
sankhārupādānakkhandhe	saṅkhārupādānakkhandhe
sankhārupādānakkhandhassa	saṅkhārupādānakkhandhassa
sankhārūpanisaṃ	saṅkhārūpanisaṃ
sankhārūpasamo	saṅkhārūpasamo
sankhārūpasamaṃ	saṅkhārūpasamaṃ
sankhārūpāyaṃ	saṅkhārūpāyaṃ
sankhitta	saṅkhitta
sankhitto	saṅkhitto
sankhittā	saṅkhittā
sankhittaṃ	saṅkhittaṃ
sankhitte	saṅkhitte
sankhittena	saṅkhittena
sankhittāya	saṅkhittāya
sankhittūposathasutta	saṅkhittūposathasutta
sankhiyadhammo	saṅkhiyadhammo
sankhiyadhammaṃ	saṅkhiyadhammaṃ
sankhepa	saṅkhepa
sankhepo	saṅkhepo
sankhepaṃ	saṅkhepaṃ
sankheyya	saṅkheyya
sankheyyaṃ	saṅkheyyaṃ
sankhyaṃ	saṅkhyaṃ
sankhya	saṅkhya
sanga	saṅga
sango	saṅgo
sangā	saṅgā
sangaṃ	saṅgaṃ
sangesu	saṅgesu
sangacchiṃ	saṅgacchiṃ
sangaṇikarato	saṅgaṇikarato
sangaṇikaratā	saṅgaṇikaratā
sangaṇikavihāro	saṅgaṇikavihāro
sangaṇikavihāraṃ	saṅgaṇikavihāraṃ
sangaṇikavihāre	saṅgaṇikavihāre
sangaṇikaṃ	saṅgaṇikaṃ
sangaṇikāya	saṅgaṇikāya
sangaṇika	saṅgaṇika
sangaṇike	saṅgaṇike
sangaṇikāpavaḍḍhano	saṅgaṇikāpavaḍḍhano
sangaṇikāratassa	saṅgaṇikāratassa
sangaṇikārāma	saṅgaṇikārāma
sangaṇikārāmo	saṅgaṇikārāmo
sangaṇikārāmā	saṅgaṇikārāmā
sangaṇikārāmassa	saṅgaṇikārāmassa
sangaṇikārāmatamanuyuttā	saṅgaṇikārāmatamanuyuttā
sangaṇikārāmatā	saṅgaṇikārāmatā
sangaṇikārāmataṃ	saṅgaṇikārāmataṃ
sangaṇikārāmasutta	saṅgaṇikārāmasutta
sangaṇhantī	saṅgaṇhantī
sangaṇhantānaṃ	saṅgaṇhantānaṃ
sangaṇha	saṅgaṇha
sangaṇhā	saṅgaṇhā
sangaṇhāti	saṅgaṇhāti
sangaṇhanti	saṅgaṇhanti
sangaṇhāsi	saṅgaṇhāsi
sangaṇhāmi	saṅgaṇhāmi
sangaṇheyyuṃ	saṅgaṇheyyuṃ
sangaṇhissanti	saṅgaṇhissanti
sangaṇhi	saṅgaṇhi
sangatā	saṅgatā
sangataṃ	saṅgataṃ
sangati	saṅgati
sangatī	saṅgatī
sangatibhāvahetu	saṅgatibhāvahetu
sangantvā	saṅgantvā
sangama	saṅgama
sangamo	saṅgamo
sangamituṃ	saṅgamituṃ
sangamūla	saṅgamūla
sangamūlaṃ	saṅgamūlaṃ
sangamma	saṅgamma
sangayhā	saṅgayhā
sangaro	saṅgaro
sangaraṃ	saṅgaraṃ
sangaha	saṅgaha
sangaho	saṅgaho
sangahā	saṅgahā
sangahaṃ	saṅgahaṃ
sangahe	saṅgahe
sangahena	saṅgahena
sangahassa	saṅgahassa
sangahāya	saṅgahāya
sangahānaṃ	saṅgahānaṃ
sangahabalaṃ	saṅgahabalaṃ
sangahasutta	saṅgahasutta
sangahavatthūni	saṅgahavatthūni
sangahavatthūhi	saṅgahavatthūhi
sangahavatthusutta	saṅgahavatthusutta
sangahita	saṅgahita
sangahito	saṅgahito
sangahitā	saṅgahitā
sangahitaṃ	saṅgahitaṃ
sangahitaparijano	saṅgahitaparijano
sangahitaparijanā	saṅgahitaparijanā
sangahitaparijjanā	saṅgahitaparijjanā
sangātigo	saṅgātigo
sangātigā	saṅgātigā
sangātigaṃ	saṅgātigaṃ
sangātigassa	saṅgātigassa
sangāma	saṅgāma
sangāmo	saṅgāmo
sangāmā	saṅgāmā
sangāmaṃ	saṅgāmaṃ
sangāme	saṅgāme
sangāmena	saṅgāmena
sangāmāya	saṅgāmāya
sangāmagato	saṅgāmagato
sangāmagataṃ	saṅgāmagataṃ
sangāmagatānaṃ	saṅgāmagatānaṃ
sangāmaji	saṅgāmaji
sangāmajiṃ	saṅgāmajiṃ
sangāmajissa	saṅgāmajissa
sangāmajisutta	saṅgāmajisutta
sangāmasīsa	saṅgāmasīsa
sangāmasīsaṃ	saṅgāmasīsaṃ
sangāmasīse	saṅgāmasīse
sangāmavijayo	saṅgāmavijayo
sangāmavijayena	saṅgāmavijayena
sangāmavijayasmiṃ	saṅgāmavijayasmiṃ
sangāmāvacaro	saṅgāmāvacaro
sangāmāvacarā	saṅgāmāvacarā
sangāmāvacarena	saṅgāmāvacarena
sangāmeti	saṅgāmeti
sangāmesi	saṅgāmesi
sangāmeyyāma	saṅgāmeyyāma
sangāmessati	saṅgāmessati
sangāmessanti	saṅgāmessanti
sangāmetuṃ	saṅgāmetuṃ
sangāmento	saṅgāmento
sangāmesuṃ	saṅgāmesuṃ
sangāyanti	saṅgāyanti
sangāyante	saṅgāyante
sangāyāma	saṅgāyāma
sangāyeyyāma	saṅgāyeyyāma
sangāyissanti	saṅgāyissanti
sangāyissāma	saṅgāyissāma
sangāyaṃ	saṅgāyaṃ
sangāyitabbaṃ	saṅgāyitabbaṃ
sangāyitabbadhamma	saṅgāyitabbadhamma
sangāyitvā	saṅgāyitvā
sangāravo	saṅgāravo
sangāravaṃ	saṅgāravaṃ
sangāravena	saṅgāravena
sangāravassa	saṅgāravassa
sangāravasutta	saṅgāravasutta
sangāravasuttaṃ	saṅgāravasuttaṃ
sangāha	saṅgāha
sangāhako	saṅgāhako
sangāhakā	saṅgāhakā
sangāhakaṃ	saṅgāhakaṃ
sangāhakassa	saṅgāhakassa
sangāhikaṃ	saṅgāhikaṃ
sangiyo	saṅgiyo
sangīta	saṅgīta
sangītā	saṅgītā
sangītāni	saṅgītāni
sangīte	saṅgīte
sangīto	saṅgīto
sangīti	saṅgīti
sangītiṃ	saṅgītiṃ
sangītiyā	saṅgītiyā
sangītipariyāyaṃ	saṅgītipariyāyaṃ
sangītisutta	saṅgītisutta
sangītisuttaṃ	saṅgītisuttaṃ
sangopeti	saṅgopeti
sangha	saṅgha
sangho	saṅgho
sanghā	saṅghā
sanghaṃ	saṅghaṃ
sanghe	saṅghe
sanghena	saṅghena
sanghebhi	saṅghebhi
sanghassa	saṅghassa
sanghānaṃ	saṅghānaṃ
sanghato	saṅghato
sanghamhā	saṅghamhā
sanghamhi	saṅghamhi
sanghasmiṃ	saṅghasmiṃ
sanghakammaṃ	saṅghakammaṃ
sanghakammāni	saṅghakammāni
sanghakaraṇīyāni	saṅghakaraṇīyāni
sanghakaraṇīyena	saṅghakaraṇīyena
sanghagata	saṅghagata
sanghagato	saṅghagato
sanghagatā	saṅghagatā
sanghagataṃ	saṅghagataṃ
sanghagatena	saṅghagatena
sanghagatāya	saṅghagatāya
sanghagarahino	saṅghagarahino
sanghagāravo	saṅghagāravo
sanghagāravatā	saṅghagāravatā
sanghaṭṭa	saṅghaṭṭa
sanghaṭṭā	saṅghaṭṭā
sanghaṭṭaṃ	saṅghaṭṭaṃ
sanghaṭṭanasamodhānā	saṅghaṭṭanasamodhānā
sanghaṭṭento	saṅghaṭṭento
sanghaṭṭentena	saṅghaṭṭentena
sanghatthero	saṅghatthero
sanghanavakā	saṅghanavakā
sanghanavakaṃ	saṅghanavakaṃ
sanghapariṇāyakā	saṅghapariṇāyakā
sanghapitaro	saṅghapitaro
sanghappaṭisaṃyuttaṃ	saṅghappaṭisaṃyuttaṃ
sanghaphāsutāya	saṅghaphāsutāya
sanghabhatta	saṅghabhatta
sanghabhattaṃ	saṅghabhattaṃ
sanghabhattā	saṅghabhattā
sanghabhatte	saṅghabhatte
sanghabheda	saṅghabheda
sanghabhedo	saṅghabhedo
sanghabhedaṃ	saṅghabhedaṃ
sanghabhede	saṅghabhede
sanghabhedena	saṅghabhedena
sanghabhedāya	saṅghabhedāya
sanghabhedaka	saṅghabhedaka
sanghabhedako	saṅghabhedako
sanghabhedakā	saṅghabhedakā
sanghabhedakaṃ	saṅghabhedakaṃ
sanghabhedakassa	saṅghabhedakassa
sanghabhedakasutta	saṅghabhedakasutta
sanghabhedasikkhāpada	saṅghabhedasikkhāpada
sanghabhedasikkhāpadaṃ	saṅghabhedasikkhāpadaṃ
sanghabhedasutta	saṅghabhedasutta
sanghamajjha	saṅghamajjha
sanghamajjhaṃ	saṅghamajjhaṃ
sanghamajjhe	saṅghamajjhe
sanghamajjhamhi	saṅghamajjhamhi
sangharakkhita	saṅgharakkhita
sangharakkhito	saṅgharakkhito
sangharakkhitā	saṅgharakkhitā
sangharakkhitaṃ	saṅgharakkhitaṃ
sangharakkhitattheragāthā	saṅgharakkhitattheragāthā
sangharāji	saṅgharāji
sangharājī	saṅgharājī
sangharāpeyya	saṅgharāpeyya
sangharāpetvā	saṅgharāpetvā
sangharitvā	saṅgharitvā
sanghasanghī	saṅghasaṅghī
sanghasaraṇagamanaṃ	saṅghasaraṇagamanaṃ
sanghasaraṇagamanahetu	saṅghasaraṇagamanahetu
sanghasāmaggīsutta	saṅghasāmaggīsutta
sanghasuṭṭhutāya	saṅghasuṭṭhutāya
sanghasobhana	saṅghasobhana
sanghasobhano	saṅghasobhano
sanghasobhanā	saṅghasobhanā
sanghassatthāya	saṅghassatthāya
sanghavandanāsutta	saṅghavandanāsutta
sanghavevacanāni	saṅghavevacanāni
sanghāṭaṃ	saṅghāṭaṃ
sanghāṭanikaṃ	saṅghāṭanikaṃ
sanghāṭi	saṅghāṭi
sanghāṭiyo	saṅghāṭiyo
sanghāṭī	saṅghāṭī
sanghāṭiṃ	saṅghāṭiṃ
sanghāṭiyā	saṅghāṭiyā
sanghāṭika	saṅghāṭika
sanghāṭiko	saṅghāṭiko
sanghāṭikaṃ	saṅghāṭikaṃ
sanghāṭikassa	saṅghāṭikassa
sanghāṭikaṇṇaggahaṇa	saṅghāṭikaṇṇaggahaṇa
sanghāṭikaṇṇaggahaṇaṃ	saṅghāṭikaṇṇaggahaṇaṃ
sanghāṭikaṇṇasutta	saṅghāṭikaṇṇasutta
sanghāṭikattaṃ	saṅghāṭikattaṃ
sanghāṭicāraṃ	saṅghāṭicāraṃ
sanghāṭicārasikkhāpada	saṅghāṭicārasikkhāpada
sanghāṭidhāraṇamattena	saṅghāṭidhāraṇamattena
sanghāṭipattacīvara	saṅghāṭipattacīvara
sanghāṭipattacīvaraṃ	saṅghāṭipattacīvaraṃ
sanghāṭipattacīvaradhāraṇaṃ	saṅghāṭipattacīvaradhāraṇaṃ
sanghāṭipattacīvaradhāraṇe	saṅghāṭipattacīvaradhāraṇe
sanghāṭipallatthikāya	saṅghāṭipallatthikāya
sanghāṭipāruto	saṅghāṭipāruto
sanghāṭipārutā	saṅghāṭipārutā
sanghāṭipārutaṃ	saṅghāṭipārutaṃ
sanghāṇi	saṅghāṇi
sanghāṇiṃ	saṅghāṇiṃ
sanghāṇisikkhāpada	saṅghāṇisikkhāpada
sanghāta	saṅghāta
sanghātaṃ	saṅghātaṃ
sanghāte	saṅghāte
sanghātaniyaṃ	saṅghātaniyaṃ
sanghātuṃ	saṅghātuṃ
sanghātherīgāthā	saṅghātherīgāthā
sanghādisesa	saṅghādisesa
sanghādiseso	saṅghādiseso
sanghādisesā	saṅghādisesā
sanghādisesaṃ	saṅghādisesaṃ
sanghādisesāni	saṅghādisesāni
sanghādisese	saṅghādisese
sanghādisesena	saṅghādisesena
sanghādisesassa	saṅghādisesassa
sanghādisesānaṃ	saṅghādisesānaṃ
sanghādisesesu	saṅghādisesesu
sanghādisesakaṇḍa	saṅghādisesakaṇḍa
sanghādisesakaṇḍaṃ	saṅghādisesakaṇḍaṃ
sanghādisesadiṭṭhi	saṅghādisesadiṭṭhi
sanghādisesadiṭṭhino	saṅghādisesadiṭṭhino
sanghādisesāpatti	saṅghādisesāpatti
sanghānussati	saṅghānussati
sanghānussatiṃ	saṅghānussatiṃ
sanghārāmo	saṅghārāmo
sanghārāmaṃ	saṅghārāmaṃ
sanghārāmassa	saṅghārāmassa
sanghārāmamhi	saṅghārāmamhi
sanghika	saṅghika
sanghiko	saṅghiko
sanghikā	saṅghikā
sanghikaṃ	saṅghikaṃ
sanghikāni	saṅghikāni
sanghike	saṅghike
sanghikena	saṅghikena
sanghikāya	saṅghikāya
sanghikacetapanasikkhāpada	saṅghikacetapanasikkhāpada
sanghikasaññī	saṅghikasaññī
sanghī	saṅghī
sanghino	saṅghino
sanghi	saṅghi
sanghiṃ	saṅghiṃ
sanghīnaṃ	saṅghīnaṃ
sanghuṭṭha	saṅghuṭṭha
sanghupaṭṭhāko	saṅghupaṭṭhāko
sanghupaṭṭhākā	saṅghupaṭṭhākā
sanghupaṭṭhākaṃ	saṅghupaṭṭhākaṃ
sanghupaṭṭhākānaṃ	saṅghupaṭṭhākānaṃ
sanghuposatha	saṅghuposatha
sanghuposathā	saṅghuposathā
sanghuposathaṃ	saṅghuposathaṃ
sanghūpasañhitā	saṅghūpasañhitā
saccavibhangasutta	saccavibhaṅgasutta
saccavibhangasuttaṃ	saccavibhaṅgasuttaṃ
saññāsankhayavimutto	saññāsaṅkhayavimutto
saññāviññāṇasankhayā	saññāviññāṇasaṅkhayā
satisambojjhango	satisambojjhaṅgo
satisambojjhangaṃ	satisambojjhaṅgaṃ
satisambojjhangassa	satisambojjhaṅgassa
satisambojjhangaṭṭhāniyānaṃ	satisambojjhaṅgaṭṭhāniyānaṃ
satisambojjhangaṭṭhānīyā	satisambojjhaṅgaṭṭhānīyā
sattangasamannāgato	sattaṅgasamannāgato
sattangasamannāgatassa	sattaṅgasamannāgatassa
sattabojjhangā	sattabojjhaṅgā
sattabojjhange	sattabojjhaṅge
sattamasanghādisesasikkhāpadaṃ	sattamasaṅghādisesasikkhāpadaṃ
sattāhakālankato	sattāhakālaṅkato
sanankumāro	sanaṅkumāro
sanankumāraṃ	sanaṅkumāraṃ
sanankumārena	sanaṅkumārena
sanankumārassa	sanaṅkumārassa
sanankumārakathā	sanaṅkumārakathā
sanankumārasutta	sanaṅkumārasutta
sandhisamalasankaṭīrā	sandhisamalasaṅkaṭīrā
sandhisamalasankaṭīre	sandhisamalasaṅkaṭīre
sabbangakalyāṇi	sabbaṅgakalyāṇi
sabbangapaccangaṃ	sabbaṅgapaccaṅgaṃ
sabbangapaccangī	sabbaṅgapaccaṅgī
sabbangapaccangiṃ	sabbaṅgapaccaṅgiṃ
sabbangasampannaṃ	sabbaṅgasampannaṃ
sabbasankhārā	sabbasaṅkhārā
sabbasankhāre	sabbasaṅkhāre
sabbasankhāresu	sabbasaṅkhāresu
sabbasankhārasamatho	sabbasaṅkhārasamatho
sabbasankhārasamathā	sabbasaṅkhārasamathā
sabbasankhārasamathaṃ	sabbasaṅkhārasamathaṃ
sabbasankhārasamathe	sabbasaṅkhārasamathe
sabbasankhārasamathāya	sabbasaṅkhārasamathāya
sabbasangātigataṃ	sabbasaṅgātigataṃ
sabbasangātigate	sabbasaṅgātigate
sabbasangāhapadakataṃ	sabbasaṅgāhapadakataṃ
sabbavankadosanihitaninnītakasāvo	sabbavaṅkadosanihitaninnītakasāvo
samangikatvā	samaṅgikatvā
samangibhūto	samaṅgibhūto
samangibhūtā	samaṅgibhūtā
samangī	samaṅgī
samangīkatvā	samaṅgīkatvā
samangībhūto	samaṅgībhūto
samangībhūtā	samaṅgībhūtā
samangībhūtaṃ	samaṅgībhūtaṃ
samangībhūte	samaṅgībhūte
samangībhūtassa	samaṅgībhūtassa
samangībhūtānaṃ	samaṅgībhūtānaṃ
samaṇangāni	samaṇaṅgāni
samaṇasanghassa	samaṇasaṅghassa
samathangatāni	samathaṅgatāni
samathapubbangamaṃ	samathapubbaṅgamaṃ
samalankatā	samalaṅkatā
samalankaritvā	samalaṅkaritvā
samādhisambojjhango	samādhisambojjhaṅgo
samādhisambojjhangaṃ	samādhisambojjhaṅgaṃ
samādhisambojjhangassa	samādhisambojjhaṅgassa
samuddangamā	samuddaṅgamā
sambādhasankhātataro	sambādhasaṅkhātataro
sambojjhangā	sambojjhaṅgā
sambojjhange	sambojjhaṅge
sambojjhangesu	sambojjhaṅgesu
sambodhiyangesu	sambodhiyaṅgesu
sammāsankappa	sammāsaṅkappa
sammāsankappo	sammāsaṅkappo
sammāsankappā	sammāsaṅkappā
sammāsankappaṃ	sammāsaṅkappaṃ
sammāsankappe	sammāsaṅkappe
sammāsankappena	sammāsaṅkappena
sammāsankappassa	sammāsaṅkappassa
sayankato	sayaṅkato
sayankatā	sayaṅkatā
sayankataṃ	sayaṅkataṃ
sayankatāni	sayaṅkatāni
sarabhango	sarabhaṅgo
sarabhangattheragāthā	sarabhaṅgattheragāthā
sarasankappā	sarasaṅkappā
sarasankappānaṃ	sarasaṅkappānaṃ
salinge	saliṅge
sasankhārā	sasaṅkhārā
sasankhāraṃ	sasaṅkhāraṃ
sasankhāraniggayhavāritagato	sasaṅkhāraniggayhavāritagato
sasankhāraniggayhavāritagataṃ	sasaṅkhāraniggayhavāritagataṃ
sasankhāraparinibbāyī	sasaṅkhāraparinibbāyī
sasankhāraparinibbāyissa	sasaṅkhāraparinibbāyissa
sasankhārasutta	sasaṅkhārasutta
sasāvakasanghe	sasāvakasaṅghe
savankā	savaṅkā
savankattā	savaṅkattā
sahassabhikkhunisangho	sahassabhikkhunisaṅgho
sahassabhikkhunisanghasutta	sahassabhikkhunisaṅghasutta
saḷāyatanavibhangā	saḷāyatanavibhaṅgā
saḷāyatanavibhangaṃ	saḷāyatanavibhaṅgaṃ
saḷāyatanavibhangassa	saḷāyatanavibhaṅgassa
saḷāyatanavibhangasutta	saḷāyatanavibhaṅgasutta
saḷāyatanavibhangasuttaṃ	saḷāyatanavibhaṅgasuttaṃ
saṃsannasankappamano	saṃsannasaṅkappamano
sākhābhangaṃ	sākhābhaṅgaṃ
sākhābhangena	sākhābhaṅgena
sāngaṇo	sāṅgaṇo
sāngaṇānaṃ	sāṅgaṇānaṃ
sāmaññangaṃ	sāmaññaṅgaṃ
sāmaññasankhātā	sāmaññasaṅkhātā
sāsankaṃ	sāsaṅkaṃ
sāsanke	sāsaṅke
sāsankasammato	sāsaṅkasammato
sāsankasammataṃ	sāsaṅkasammataṃ
sāsankasammatāni	sāsaṅkasammatāni
sāsankasammate	sāsaṅkasammate
sāsankasikkhāpada	sāsaṅkasikkhāpada
sāsankasikkhāpadaṃ	sāsaṅkasikkhāpadaṃ
sāvakasangho	sāvakasaṅgho
sāvajjasankhātā	sāvajjasaṅkhātā
singa	siṅga
singā	siṅgā
singāla	siṅgāla
singāle	siṅgāle
singālo	siṅgālo
singālā	siṅgālā
singālaṃ	siṅgālaṃ
singālehi	siṅgālehi
singālānaṃ	siṅgālānaṃ
singālaka	siṅgālaka
singālako	siṅgālako
singālakā	siṅgālakā
singālakaṃ	siṅgālakaṃ
singālakamātā	siṅgālakamātā
singālakamāta	siṅgālakamāta
singālapituttheragāthā	siṅgālapituttheragāthā
singālasutta	siṅgālasutta
singālasuttaṃ	siṅgālasuttaṃ
singiyo	siṅgiyo
singiveraṃ	siṅgiveraṃ
singī	siṅgī
singi	siṅgi
singinā	siṅginā
singīhi	siṅgīhi
singīnikkha	siṅgīnikkha
singīnikkhassa	siṅgīnikkhassa
singīnikkhasatassa	siṅgīnikkhasatassa
singīvaṇṇaṃ	siṅgīvaṇṇaṃ
singhāmi	siṅghāmi
singhāṭaka	siṅghāṭaka
singhāṭakaṃ	siṅghāṭakaṃ
singhāṭake	siṅghāṭake
singhāṭakena	siṅghāṭakena
singhāṭakesu	siṅghāṭakesu
singhāṭako	siṅghāṭako
singhāṇikā	siṅghāṇikā
singhāṇikāya	siṅghāṇikāya
singhānikā	siṅghānikā
sīlapārisuddhipadhāniyangaṃ	sīlapārisuddhipadhāniyaṅgaṃ
sīlapārisuddhipadhāniyangena	sīlapārisuddhipadhāniyaṅgena
sukkasankhātā	sukkasaṅkhātā
sugatangulena	sugataṅgulena
sunko	suṅko
sunkaṃ	suṅkaṃ
sunkena	suṅkena
sunkaghātaṃ	suṅkaghātaṃ
sunkaṭṭhānaṃ	suṅkaṭṭhānaṃ
sunkadāyakaṃ	suṅkadāyakaṃ
suttantasankhepā	suttantasaṅkhepā
suddhasankhārapuñjo	suddhasaṅkhārapuñjo
subhaddādeviupasankamana	subhaddādeviupasaṅkamana
sumangala	sumaṅgala
sumangalo	sumaṅgalo
sumangalā	sumaṅgalā
sumangalaṃ	sumaṅgalaṃ
sumangalattheragāthā	sumaṅgalattheragāthā
sumangalamātātherīgāthā	sumaṅgalamātātherīgāthā
susankhatā	susaṅkhatā
susankhataṃ	susaṅkhataṃ
susankhatehi	susaṅkhatehi
susangahita	susaṅgahita
susangahito	susaṅgahito
susangahitā	susaṅgahitā
susangahitaṃ	susaṅgahitaṃ
susangahitāni	susaṅgahitāni
susangahitattā	susaṅgahitattā
susangahitaparijano	susaṅgahitaparijano
susamāhitasankappā	susamāhitasaṅkappā
suvaṇṇabhinkāraṃ	suvaṇṇabhiṅkāraṃ
seṭṭhasankappo	seṭṭhasaṅkappo
setālankārā	setālaṅkārā
sevitabbasankhātā	sevitabbasaṅkhātā
soṇasingālā	soṇasiṅgālā
sotāpattiyangaṃ	sotāpattiyaṅgaṃ
sotāpattiyangāni	sotāpattiyaṅgāni
sotāpattiyangehi	sotāpattiyaṅgehi
sotāpattiyangāna	sotāpattiyaṅgāna
sotāpattiyangesu	sotāpattiyaṅgesu
sovaṇṇālankārāni	sovaṇṇālaṅkārāni
soḷasangulakaṇṭakaṃ	soḷasaṅgulakaṇṭakaṃ
vanka	vaṅka
vankā	vaṅkā
vankaṃ	vaṅkaṃ
vankakaṃ	vaṅkakaṃ
vankakena	vaṅkakena
vankako	vaṅkako
vankaghasto	vaṅkaghasto
vankanguliṃ	vaṅkaṅguliṃ
vankadaṇḍā	vaṅkadaṇḍā
vankeyyāni	vaṅkeyyāni
vangānaṃ	vaṅgānaṃ
vangantaputto	vaṅgantaputto
vangantaputtaṃ	vaṅgantaputtaṃ
vangantaputtassa	vaṅgantaputtassa
vangantaputtaupasenattheragāthā	vaṅgantaputtaupasenattheragāthā
vangiso	vaṅgiso
vangīsa	vaṅgīsa
vangīso	vaṅgīso
vangīsā	vaṅgīsā
vangīsena	vaṅgīsena
vangīsassa	vaṅgīsassa
vangīsattheragāthā	vaṅgīsattheragāthā
vangīsasaṃyuttaṃ	vaṅgīsasaṃyuttaṃ
vangīsasutta	vaṅgīsasutta
vacīduccaritasamangī	vacīduccaritasamaṅgī
vacīsankhāro	vacīsaṅkhāro
vacīsankhārā	vacīsaṅkhārā
vacīsankhāraṃ	vacīsaṅkhāraṃ
vacīsankhārānaṃ	vacīsaṅkhārānaṃ
vacīsucaritasamangī	vacīsucaritasamaṅgī
vacīvanko	vacīvaṅko
vacīvankaṃ	vacīvaṅkaṃ
vacīvankānaṃ	vacīvaṅkānaṃ
vanabhangena	vanabhaṅgena
vasangato	vasaṅgato
vasangatā	vasaṅgatā
vādasanghāṭena	vādasaṅghāṭena
vāḷamigasanghasevitaṃ	vāḷamigasaṅghasevitaṃ
vigatakathankatho	vigatakathaṅkatho
vigatakathankathā	vigatakathaṅkathā
vigatakathankathaṃ	vigatakathaṅkathaṃ
vicikicchākathankathāsallaṃ	vicikicchākathaṅkathāsallaṃ
vicikicchākathankathāsallassa	vicikicchākathaṅkathāsallassa
vijitasangāma	vijitasaṅgāma
vijitasangāmo	vijitasaṅgāmo
vijitasangāmā	vijitasaṅgāmā
vijitasangāmaṃ	vijitasaṅgāmaṃ
vijitasangāmassa	vijitasaṅgāmassa
viññāṇasankhayavimutto	viññāṇasaṅkhayavimutto
viññāṇasankhāyavimutto	viññāṇasaṅkhāyavimutto
vitakkasankhārasaṇṭhānaṃ	vitakkasaṅkhārasaṇṭhānaṃ
vitiṇṇakankho	vitiṇṇakaṅkho
vipassanāpubbangamaṃ	vipassanāpubbaṅgamaṃ
vibhanga	vibhaṅga
vibhango	vibhaṅgo
vibhangā	vibhaṅgā
vibhangaṃ	vibhaṅgaṃ
vibhange	vibhaṅge
vibhangena	vibhaṅgena
vibhangako	vibhaṅgako
vibhangasutta	vibhaṅgasutta
vibhangavaggo	vibhaṅgavaggo
vimuttipārisuddhipadhāniyangaṃ	vimuttipārisuddhipadhāniyaṅgaṃ
visanketena	visaṅketena
visankhataṃ	visaṅkhataṃ
visankhāragataṃ	visaṅkhāragataṃ
vihangamo	vihaṅgamo
vihangamā	vihaṅgamā
vihangame	vihaṅgame
vihiṃsāsankappo	vihiṃsāsaṅkappo
vītangārā	vītaṅgārā
vītaccitangāraṃ	vītaccitaṅgāraṃ
vīmaṃsasamādhipadhānasankhārasamannāgataṃ	vīmaṃsasamādhipadhānasaṅkhārasamannāgataṃ
vīmaṃsāsamādhipadhānasankhārasamannāgataṃ	vīmaṃsāsamādhipadhānasaṅkhārasamannāgataṃ
vīmaṃsāsamādhippadhānasankhārasamannāgato	vīmaṃsāsamādhippadhānasaṅkhārasamannāgato
vīmaṃsāsamādhippadhānasankhārasamannāgataṃ	vīmaṃsāsamādhippadhānasaṅkhārasamannāgataṃ
vīrangarūpā	vīraṅgarūpā
vīriyasamādhipadhānasankhārasamannāgataṃ	vīriyasamādhipadhānasaṅkhārasamannāgataṃ
vīriyasamādhippadhānasankhārasamannāgato	vīriyasamādhippadhānasaṅkhārasamannāgato
vīriyasamādhippadhānasankhārasamannāgataṃ	vīriyasamādhippadhānasaṅkhārasamannāgataṃ
vīriyasambojjhango	vīriyasambojjhaṅgo
vīriyasambojjhangaṃ	vīriyasambojjhaṅgaṃ
vīriyasambojjhangassa	vīriyasambojjhaṅgassa
vekaḷinge	vekaḷiṅge
vegaḷingaṃ	vegaḷiṅgaṃ
vegaḷinge	vegaḷiṅge
vedanāsankhayavimutto	vedanāsaṅkhayavimutto
vedanāsankhāyavimutto	vedanāsaṅkhāyavimutto
vehāsangamo	vehāsaṅgamo
hatthavilanghakena	hatthavilaṅghakena
hadayangamā	hadayaṅgamā
hadayangamaṃ	hadayaṅgamaṃ
hingo	hiṅgo
hingu	hiṅgu
hinguṃ	hiṅguṃ
hingū	hiṅgū
huṃhunkasutta	huṃhuṅkasutta
hetubhangā	hetubhaṅgā
purisālankāraṃ	purisālaṅkāraṃ
angulipabbamatta	aṅgulipabbamatta
angulipabbamattaṃ	aṅgulipabbamattaṃ
parisuddhasankhātataro	parisuddhasaṅkhātataro
parisuddhasankhātatarā	parisuddhasaṅkhātatarā
sankīḷati	saṅkīḷati
sankīḷanti	saṅkīḷanti
sankelāyati	saṅkelāyati
sankheyyake	saṅkheyyake
gamikābhisankhāro	gamikābhisaṅkhāro
sangahetabbo	saṅgahetabbo
sangahetuṃ	saṅgahetuṃ
sangahesuṃ	saṅgahesuṃ
sampadamākankhī	sampadamākaṅkhī
singīsuvaṇṇaṃ	siṅgīsuvaṇṇaṃ
amanāpasankhātaṃ	amanāpasaṅkhātaṃ
sanghasammuti	saṅghasammuti
nālamariyasankhātā	nālamariyasaṅkhātā
asangāhako	asaṅgāhako
tadanganibbānaṃ	tadaṅganibbānaṃ
pañcangasampanno	pañcaṅgasampanno
kajangalakā	kajaṅgalakā
kajangalikā	kajaṅgalikā
kajangalikaṃ	kajaṅgalikaṃ
kajangalikāya	kajaṅgalikāya
sanghasāmaggī	saṅghasāmaggī
sanghasāmaggiyo	saṅghasāmaggiyo
sanghasāmaggiṃ	saṅghasāmaggiṃ
sanghasāmaggiyā	saṅghasāmaggiyā
sanghasāmaggi	saṅghasāmaggi
micchāsankappapaccayā	micchāsaṅkappapaccayā
sammāsankappapaccayā	sammāsaṅkappapaccayā
kammanidānasankhayo	kammanidānasaṅkhayo
mālānānālankārassa	mālānānālaṅkārassa
uddhankhitto	uddhaṅkhitto
anguttarasamāyuta	aṅguttarasamāyuta
anguttarasamāyutā	aṅguttarasamāyutā
evankaṭukaṃ	evaṅkaṭukaṃ
sankhittabalasutta	saṅkhittabalasutta
sankhittadhanasutta	saṅkhittadhanasutta
evankamanīyo	evaṅkamanīyo
dutiyasankhittasutta	dutiyasaṅkhittasutta
tatiyasankhittasutta	tatiyasaṅkhittasutta
paṭhamasankhittasutta	paṭhamasaṅkhittasutta
sankhittasutta	saṅkhittasutta
acankame	acaṅkame
vangīsavagga	vaṅgīsavagga
sankhittadhammasutta	saṅkhittadhammasutta
sankiṇṇaparikkho	saṅkiṇṇaparikkho
kathankārī	kathaṅkārī
alingaṃ	aliṅgaṃ
alinge	aliṅge
alingassa	aliṅgassa
